;Time Interval;Average Packet Size;Average Packet Intervals;Inbound Packets;Outbound Packets;Total Packets;Persona
0;(0, 0.5);956.1142857142858;0.004413123809523808;47;58;105;1
1;(0.5, 1.0);933.6449275362319;0.003510427536231883;77;61;138;1
2;(1.0, 1.5);919.2272727272727;0.003204649350649352;95;59;154;1
3;(1.5, 2.0);955.7131147540983;0.004065868852459018;64;58;122;1
4;(2.0, 2.5);929.561403508772;0.004377578947368422;61;53;114;1
5;(2.5, 3.0);911.824074074074;0.004087324074074073;60;48;108;1
6;(3.0, 3.5);884.9237288135594;0.00424514406779661;68;50;118;1
7;(3.5, 4.0);893.8672566371681;0.004432893805309732;65;48;113;1
8;(4.0, 4.5);935.747572815534;0.004850757281553396;58;45;103;1
9;(4.5, 5.0);895.2521739130435;0.004255304347826086;67;48;115;1
10;(5.0, 5.5);950.9142857142857;0.004737038095238094;59;46;105;1
11;(5.5, 6.0);944.6422018348624;0.004414394495412844;64;45;109;1
12;(6.0, 6.5);959.3960396039604;0.004889445544554458;54;47;101;1
13;(6.5, 7.0);878.1129032258065;0.0038007822580645146;74;50;124;1
14;(7.0, 7.5);931.8018018018018;0.004518837837837838;63;48;111;1
15;(7.5, 8.0);948.6630434782609;0.004912141304347826;54;38;92;1
16;(8.0, 8.5);888.2636363636364;0.004775499999999997;66;44;110;1
17;(8.5, 9.0);866.6355140186915;0.004490018691588784;67;40;107;1
18;(9.0, 9.5);943.8762886597938;0.005189742268041235;55;42;97;1
19;(9.5, 10.0);928.6574074074074;0.004484259259259258;63;45;108;1
20;(10.0, 10.5);886.288;0.003873976;67;58;125;1
21;(10.5, 11.0);884.438596491228;0.004305815789473683;59;55;114;1
22;(11.0, 11.5);908.9661016949152;0.004106466101694913;66;52;118;1
23;(11.5, 12.0);911.4727272727273;0.004342672727272726;58;52;110;1
24;(12.0, 12.5);899.4035087719299;0.004308149122807018;62;52;114;1
25;(12.5, 13.0);868.9921875;0.0038509921874999996;66;62;128;1
26;(13.0, 13.5);938.109243697479;0.0040946302521008395;58;61;119;1
27;(13.5, 14.0);913.1523178807947;0.0033376754966887396;68;83;151;1
28;(14.0, 14.5);862.3164556962025;0.003031139240506329;73;85;158;1
29;(14.5, 15.0);912.2620689655172;0.0033578827586206866;62;83;145;1
30;(15.0, 15.5);881.3478260869565;0.003524217391304347;52;86;138;1
31;(15.5, 16.0);917.3525641025641;0.0031799102564102543;77;79;156;1
32;(16.0, 16.5);917.9791666666666;0.0034217916666666663;61;83;144;1
33;(16.5, 17.0);891.5244755244755;0.00351360839160839;59;84;143;1
34;(17.0, 17.5);888.3576158940398;0.0032033178807946996;63;88;151;1
35;(17.5, 18.0);883.0945945945946;0.0033033648648648642;65;83;148;1
36;(18.0, 18.5);870.6486486486486;0.0032262364864864847;64;84;148;1
37;(18.5, 19.0);895.4615384615385;0.003221621794871794;72;84;156;1
38;(19.0, 19.5);890.3093525179856;0.0035887769784172653;52;87;139;1
39;(19.5, 20.0);891.3263888888889;0.003446027777777776;59;85;144;1
40;(20.0, 20.5);902.2573529411765;0.0036695220588235282;53;83;136;1
41;(20.5, 21.0);833.9150326797386;0.0032166862745098036;60;93;153;1
42;(21.0, 21.5);875.0895522388059;0.003582104477611938;48;86;134;1
43;(21.5, 22.0);825.2428571428571;0.003320392857142855;62;78;140;1
44;(22.0, 22.5);868.1880341880342;0.004267641025641026;57;60;117;1
45;(22.5, 23.0);871.8615384615384;0.0038578076923076908;75;55;130;1
46;(23.0, 23.5);875.4285714285714;0.0032341928571428587;92;48;140;1
47;(23.5, 24.0);806.3758865248227;0.0035394113475177313;89;52;141;1
48;(24.0, 24.5);835.2148148148148;0.003591296296296295;88;47;135;1
49;(24.5, 25.0);836.2033898305085;0.004223254237288137;63;55;118;1
50;(25.0, 25.5);844.05;0.0034313285714285702;83;57;140;1
51;(25.5, 26.0);849.3934426229508;0.004037008196721311;68;54;122;1
52;(26.0, 26.5);823.8712121212121;0.003701113636363635;67;65;132;1
53;(26.5, 27.0);885.195652173913;0.0036093550724637675;76;62;138;1
54;(27.0, 27.5);898.5241935483871;0.0038734596774193534;68;56;124;1
55;(27.5, 28.0);795.5625;0.003598171874999998;72;56;128;1
56;(28.0, 28.5);836.2457627118644;0.004117152542372878;67;51;118;1
57;(28.5, 29.0);837.595041322314;0.004165256198347108;68;53;121;1
58;(29.0, 29.5);816.1654135338346;0.00373393984962406;74;59;133;1
59;(29.5, 30.0);887.1290322580645;0.004013758064516129;68;56;124;1
60;(30.0, 30.5);917.2434782608696;0.00435633913043478;59;56;115;1
61;(30.5, 31.0);872.4242424242424;0.003595371212121212;80;52;132;1
62;(31.0, 31.5);886.7259259259259;0.0036780074074074056;71;64;135;1
63;(31.5, 32.0);853.4173913043478;0.0042015043478260865;65;50;115;1
64;(32.0, 32.5);894.3865546218487;0.004188268907563025;68;51;119;1
65;(32.5, 33.0);820.3140495867768;0.0035162561983471054;71;50;121;1
66;(33.0, 33.5);779.6974789915967;0.004243495798319326;74;45;119;1
67;(33.5, 34.0);827.5652173913044;0.004337417391304345;67;48;115;1
68;(34.0, 34.5);926.4351145038167;0.0038256335877862595;74;57;131;1
69;(34.5, 35.0);890.3211009174312;0.0043861284403669725;58;51;109;1
70;(35.0, 35.5);896.3228346456693;0.0038337244094488166;74;53;127;1
71;(35.5, 36.0);938.8925619834711;0.0041078760330578515;68;53;121;1
72;(36.0, 36.5);950.5;0.004357149122807015;63;51;114;1
73;(36.5, 37.0);965.6666666666666;0.0034017517730496436;78;63;141;1
74;(37.0, 37.5);986.4765625;0.003911828124999997;70;58;128;1
75;(37.5, 38.0);980.3178294573644;0.0036949844961240287;67;62;129;1
76;(38.0, 38.5);991.9015151515151;0.0037089015151515145;76;56;132;1
77;(38.5, 39.0);1012.0420168067227;0.004084504201680672;61;58;119;1
78;(39.0, 39.5);1026.3543307086613;0.003912992125984252;72;55;127;1
79;(39.5, 40.0);1006.1653543307086;0.003904771653543308;71;56;127;1
80;(40.0, 40.5);990.8515625;0.003939179687499999;71;57;128;1
81;(40.5, 41.0);911.2481203007519;0.003526203007518797;72;61;133;1
82;(41.0, 41.5);1038.78125;0.0038676250000000013;72;56;128;1
83;(41.5, 42.0);1005.937984496124;0.0038410620155038774;68;61;129;1
84;(42.0, 42.5);1003.8;0.004029279999999999;67;58;125;1
85;(42.5, 43.0);1024.7874015748032;0.003651748031496061;72;55;127;1
86;(43.0, 43.5);1020.9609375;0.003939210937499998;65;63;128;1
87;(43.5, 44.0);1035.857142857143;0.0038892301587301575;69;57;126;1
88;(44.0, 44.5);949.3093525179856;0.0034881510791366895;75;64;139;1
89;(44.5, 45.0);1042.1463414634147;0.003931341463414634;67;56;123;1
90;(45.0, 45.5);1025.9126984126983;0.0039350238095238075;66;60;126;1
91;(45.5, 46.0);1014.4921875;0.003808968749999998;71;57;128;1
92;(46.0, 46.5);1012.48;0.004013824000000003;65;60;125;1
93;(46.5, 47.0);1008.0;0.00393890243902439;66;57;123;1
94;(47.0, 47.5);1026.4057971014493;0.0036358333333333342;75;63;138;1
95;(47.5, 48.0);976.5851851851852;0.0036360518518518507;74;61;135;1
96;(48.0, 48.5);925.3779527559055;0.003933370078740159;67;60;127;1
97;(48.5, 49.0);1015.2426470588235;0.00334610294117647;75;61;136;1
98;(49.0, 49.5);1006.560975609756;0.0040416016260162585;63;60;123;1
99;(49.5, 50.0);1009.6910569105692;0.004054341463414633;67;56;123;1
100;(50.0, 50.5);1029.0916030534352;0.0036638549618320604;72;59;131;1
101;(50.5, 51.0);990.9842519685039;0.0039159370078740135;69;58;127;1
102;(51.0, 51.5);1058.1351351351352;0.004344396396396394;59;52;111;1
103;(51.5, 52.0);974.8251748251748;0.0034220629370629364;77;66;143;1
104;(52.0, 52.5);1009.7851239669421;0.00407690909090909;63;58;121;1
105;(52.5, 53.0);1000.2260869565217;0.0041872347826086955;60;55;115;1
106;(53.0, 53.5);1009.5859375;0.0038200234374999994;66;62;128;1
107;(53.5, 54.0);988.763358778626;0.003769534351145035;68;63;131;1
108;(54.0, 54.5);998.7213114754098;0.0038894918032786885;62;60;122;1
109;(54.5, 55.0);1036.0381679389313;0.0038820229007633608;71;60;131;1
110;(55.0, 55.5);961.9124087591241;0.0035327883211678807;74;63;137;1
111;(55.5, 56.0);953.9685039370079;0.0038803543307086618;68;59;127;1
112;(56.0, 56.5);1029.9022556390978;0.003724714285714286;75;58;133;1
113;(56.5, 57.0);1025.3983050847457;0.004240694915254237;62;56;118;1
114;(57.0, 57.5);993.2113821138212;0.00403970731707317;63;60;123;1
115;(57.5, 58.0);1003.4924242424242;0.0035699848484848484;73;59;132;1
116;(58.0, 58.5);1035.452380952381;0.004044999999999998;67;59;126;1
117;(58.5, 59.0);1009.991452991453;0.004279863247863247;58;59;117;1
118;(59.0, 59.5);968.6402877697842;0.0034566330935251795;78;61;139;1
119;(59.5, 60.0);1004.7557251908397;0.0038358473282442745;71;60;131;1
120;(60.0, 60.5);1071.090909090909;0.004080933884297519;64;57;121;1
121;(60.5, 61.0);993.4666666666667;0.004112774999999998;57;63;120;0
122;(61.0, 61.5);1036.6439393939395;0.00357665909090909;73;59;132;0
123;(61.5, 62.0);1040.388429752066;0.004035016528925619;65;56;121;0
124;(62.0, 62.5);1015.219696969697;0.003831946969696967;73;59;132;0
125;(62.5, 63.0);973.7075471698113;0.00457120754716981;44;62;106;0
126;(63.0, 63.5);960.1592356687898;0.003150891719745223;93;64;157;0
127;(63.5, 64.0);1007.0;0.0036963759398496213;75;58;133;0
128;(64.0, 64.5);1018.5241935483871;0.0038862177419354826;65;59;124;0
129;(64.5, 65.0);968.6640625;0.0038833359375;68;60;128;0
130;(65.0, 65.5);993.9848484848485;0.003629174242424241;73;59;132;0
131;(65.5, 66.0);990.921875;0.003913890624999998;71;57;128;0
132;(66.0, 66.5);1001.5378151260504;0.004147058823529412;65;54;119;0
133;(66.5, 67.0);901.8356164383562;0.0033032328767123274;79;67;146;0
134;(67.0, 67.5);918.3559322033898;0.004283305084745764;70;48;118;0
135;(67.5, 68.0);989.0088495575221;0.004255035398230087;60;53;113;0
136;(68.0, 68.5);936.7786885245902;0.003954319672131147;69;53;122;0
137;(68.5, 69.0);966.8333333333334;0.004248833333333331;65;49;114;0
138;(69.0, 69.5);931.188679245283;0.004924830188679242;63;43;106;0
139;(69.5, 70.0);966.7227722772277;0.004859960396039602;68;33;101;0
140;(70.0, 70.5);915.8632478632478;0.004043769230769233;68;49;117;0
141;(70.5, 71.0);864.1467889908257;0.00459875229357798;67;42;109;0
142;(71.0, 71.5);904.3962264150944;0.004680650943396225;74;32;106;0
143;(71.5, 72.0);987.7894736842105;0.005241357894736841;71;24;95;0
144;(72.0, 72.5);933.7215189873418;0.006100683544303798;51;28;79;0
145;(72.5, 73.0);974.9509803921569;0.004721127450980391;75;27;102;0
146;(73.0, 73.5);991.8804347826087;0.005144510869565219;64;28;92;0
147;(73.5, 74.0);979.4772727272727;0.005385159090909092;65;23;88;0
148;(74.0, 74.5);873.875;0.004809817307692307;73;31;104;0
149;(74.5, 75.0);989.9550561797753;0.005449101123595506;65;24;89;0
150;(75.0, 75.5);983.2631578947369;0.005759749999999999;56;20;76;0
151;(75.5, 76.0);994.56;0.004787389999999999;73;27;100;0
152;(76.0, 76.5);963.0119047619048;0.005834571428571427;62;22;84;0
153;(76.5, 77.0);921.2439024390244;0.005514768292682927;56;26;82;0
154;(77.0, 77.5);979.1037735849056;0.004800028301886794;77;29;106;0
155;(77.5, 78.0);936.6808510638298;0.004747627659574469;67;27;94;0
156;(78.0, 78.5);893.395061728395;0.005257222222222222;57;24;81;0
157;(78.5, 79.0);980.7788461538462;0.005224903846153845;80;24;104;0
158;(79.0, 79.5);958.6413043478261;0.005481608695652171;64;28;92;0
159;(79.5, 80.0);932.202380952381;0.005834488095238092;57;27;84;0
160;(80.0, 80.5);974.5869565217391;0.005386641304347825;66;26;92;0
161;(80.5, 81.0);1007.989247311828;0.005396333333333333;68;25;93;0
162;(81.0, 81.5);980.0138888888889;0.0062034444444444455;51;21;72;0
163;(81.5, 82.0);887.1574074074074;0.004622296296296295;75;33;108;0
164;(82.0, 82.5);952.625;0.004593614583333333;68;28;96;0
165;(82.5, 83.0);1079.5;0.004753017241379311;62;54;116;0
166;(83.0, 83.5);1084.1278195488721;0.003506218045112782;79;54;133;0
167;(83.5, 84.0);915.0;0.0030171948051948044;68;86;154;0
168;(84.0, 84.5);960.5073529411765;0.0034583676470588223;56;80;136;0
169;(84.5, 85.0);1018.3076923076923;0.003208884615384614;76;80;156;0
170;(85.0, 85.5);937.8839285714286;0.0043069999999999975;32;80;112;0
171;(85.5, 86.0);965.2857142857143;0.003332605442176869;64;83;147;0
172;(86.0, 86.5);1011.9344262295082;0.0025628743169398907;99;84;183;0
173;(86.5, 87.0);982.0227272727273;0.0036380454545454515;52;80;132;0
174;(87.0, 87.5);946.7923076923076;0.00352586923076923;49;81;130;0
175;(87.5, 88.0);925.9119496855346;0.0031493836477987404;77;82;159;0
176;(88.0, 88.5);895.0479452054794;0.003245794520547947;63;83;146;0
177;(88.5, 89.0);931.07299270073;0.003550649635036495;59;78;137;0
178;(89.0, 89.5);855.7098765432099;0.0030033333333333335;75;87;162;0
179;(89.5, 90.0);920.3661971830986;0.0033602816901408443;64;78;142;0
180;(90.0, 90.5);937.7028985507246;0.0036898550724637647;59;79;138;0
181;(90.5, 91.0);904.8815789473684;0.0031926842105263146;71;81;152;0
182;(91.0, 91.5);925.8661971830986;0.0034962676056338026;63;79;142;0
183;(91.5, 92.0);924.6301369863014;0.0033021369863013694;64;82;146;0
184;(92.0, 92.5);933.3884892086331;0.0035521223021582715;63;76;139;0
185;(92.5, 93.0);876.6183206106871;0.0035423129770992346;48;83;131;0
186;(93.0, 93.5);903.4285714285714;0.0030291677018633527;79;82;161;0
187;(93.5, 94.0);923.1409395973154;0.003254161073825501;68;81;149;0
188;(94.0, 94.5);931.5675675675676;0.0033765067567567545;63;85;148;0
189;(94.5, 95.0);938.4198473282443;0.0036978549618320597;48;83;131;0
190;(95.0, 95.5);916.4244186046511;0.0028953139534883708;83;89;172;0
191;(95.5, 96.0);931.431506849315;0.003296691780821917;63;83;146;0
192;(96.0, 96.5);927.8716216216217;0.003403905405405404;62;86;148;0
193;(96.5, 97.0);882.6144578313254;0.002872993975903612;75;91;166;0
194;(97.0, 97.5);945.2986111111111;0.0035077430555555547;60;84;144;0
195;(97.5, 98.0);945.020979020979;0.0034403496503496484;61;82;143;0
196;(98.0, 98.5);940.5324675324675;0.0030073506493506486;67;87;154;0
197;(98.5, 99.0);945.3877551020408;0.0034336462585033986;67;80;147;0
198;(99.0, 99.5);940.3661971830986;0.0033763239436619707;59;83;142;0
199;(99.5, 100.0);955.86;0.0033525066666666658;68;82;150;0
200;(100.0, 100.5);924.4342105263158;0.0030920328947368404;67;85;152;0
201;(100.5, 101.0);925.6760563380282;0.003556028169014083;57;85;142;0
202;(101.0, 101.5);956.7651006711409;0.0032101476510067103;69;80;149;0
203;(101.5, 102.0);954.9324324324324;0.003398405405405404;66;82;148;0
204;(102.0, 102.5);956.2877697841726;0.0035466906474820132;58;81;139;0
205;(102.5, 103.0);932.25;0.0032444671052631567;68;84;152;0
206;(103.0, 103.5);926.5;0.003962008196721311;39;83;122;0
207;(103.5, 104.0);934.516393442623;0.0036857540983606554;60;62;122;0
208;(104.0, 104.5);754.5882352941177;0.004788705882352939;73;29;102;0
209;(104.5, 105.0);834.3875;0.006116887499999996;60;20;80;0
210;(105.0, 105.5);844.2105263157895;0.0042593596491228075;85;29;114;0
211;(105.5, 106.0);805.1978021978022;0.00542423076923077;72;19;91;0
212;(106.0, 106.5);867.7831325301205;0.005900722891566265;67;16;83;0
213;(106.5, 107.0);883.2368421052631;0.006537842105263155;60;16;76;0
214;(107.0, 107.5);884.9113924050633;0.006187354430379746;64;15;79;0
215;(107.5, 108.0);814.0344827586207;0.00539567816091954;69;18;87;0
216;(108.0, 108.5);771.8255813953489;0.005720267441860467;65;21;86;0
217;(108.5, 109.0);863.4494382022472;0.004889707865168539;71;18;89;0
218;(109.0, 109.5);827.5357142857143;0.0058455595238095254;65;19;84;0
219;(109.5, 110.0);852.6538461538462;0.0051914102564102555;61;17;78;0
220;(110.0, 110.5);872.7272727272727;0.005349136363636362;70;18;88;0
221;(110.5, 111.0);862.4941176470588;0.005370999999999997;65;20;85;0
222;(111.0, 111.5);850.6056338028169;0.006635732394366196;56;15;71;0
223;(111.5, 112.0);779.8076923076923;0.0046715384615384605;77;27;104;0
224;(112.0, 112.5);853.4137931034483;0.005688816091954023;68;19;87;0
225;(112.5, 113.0);820.4235294117647;0.00495215294117647;62;23;85;0
226;(113.0, 113.5);850.4943820224719;0.0056830898876404495;68;21;89;0
227;(113.5, 114.0);826.4318181818181;0.005545704545454543;65;23;88;0
228;(114.0, 114.5);869.4133333333333;0.005101039999999999;61;14;75;0
229;(114.5, 115.0);852.6860465116279;0.005742499999999998;69;17;86;0
230;(115.0, 115.5);798.2391304347826;0.004894347826086957;65;27;92;0
231;(115.5, 116.0);793.8333333333334;0.005134447916666667;70;26;96;0
232;(116.0, 116.5);849.2558139534884;0.0058193023255813945;66;20;86;0
233;(116.5, 117.0);855.5060240963855;0.005757807228915663;62;21;83;0
234;(117.0, 117.5);839.8202247191011;0.0054107303370786505;66;23;89;0
235;(117.5, 118.0);848.8313253012049;0.006047542168674698;62;21;83;0
236;(118.0, 118.5);836.6941176470589;0.005154023529411767;65;20;85;0
237;(118.5, 119.0);852.6976744186046;0.005858151162790698;64;22;86;0
238;(119.0, 119.5);769.4897959183673;0.004950224489795917;73;25;98;0
239;(119.5, 120.0);845.3625;0.005921374999999998;61;19;80;0
240;(120.0, 120.5);836.2588235294118;0.0055234588235294115;64;21;85;0
241;(120.5, 121.0);827.2371134020618;0.005481917525773198;69;28;97;0
242;(121.0, 121.5);820.3070175438596;0.004175833333333333;63;51;114;1
243;(121.5, 122.0);809.0322580645161;0.005234655913978493;66;27;93;1
244;(122.0, 122.5);848.2105263157895;0.005205210526315788;68;27;95;1
245;(122.5, 123.0);798.990099009901;0.004656762376237624;66;35;101;1
246;(123.0, 123.5);906.3382352941177;0.003603727941176469;66;70;136;1
247;(123.5, 124.0);956.07299270073;0.0036598321167883195;70;67;137;1
248;(124.0, 124.5);968.4685314685315;0.003291524475524473;69;74;143;1
249;(124.5, 125.0);957.0723684210526;0.0033106776315789464;70;82;152;1
250;(125.0, 125.5);964.203947368421;0.0032297302631578957;71;81;152;1
251;(125.5, 126.0);935.0340136054422;0.003397115646258503;61;86;147;1
252;(126.0, 126.5);955.1392405063291;0.0030735759493670874;75;83;158;1
253;(126.5, 127.0);924.7018633540373;0.003000248447204968;73;88;161;1
254;(127.0, 127.5);962.5342465753424;0.0033748219178082167;62;84;146;1
255;(127.5, 128.0);975.1543209876543;0.003102932098765429;78;84;162;1
256;(128.0, 128.5);945.3181818181819;0.003173214285714284;64;90;154;1
257;(128.5, 129.0);1003.5436241610738;0.0033053624161073804;65;84;149;1
258;(129.0, 129.5);1052.879746835443;0.0031371202531645555;76;82;158;1
259;(129.5, 130.0);1074.0223880597016;0.003736089552238804;52;82;134;1
260;(130.0, 130.5);1059.168;0.003938799999999998;47;78;125;1
261;(130.5, 131.0);1012.2592592592592;0.0035030666666666654;52;83;135;1
262;(131.0, 131.5);1049.0;0.003574437956204377;59;78;137;1
263;(131.5, 132.0);1087.2478632478633;0.004034290598290598;60;57;117;1
264;(132.0, 132.5);1146.211009174312;0.004558944954128439;59;50;109;1
265;(132.5, 133.0);1087.8015873015872;0.003924214285714285;75;51;126;1
266;(133.0, 133.5);1039.7142857142858;0.004043361344537814;66;53;119;1
267;(133.5, 134.0);1084.1339285714287;0.004361321428571427;61;51;112;1
268;(134.0, 134.5);1000.5615384615385;0.0037098692307692303;73;57;130;1
269;(134.5, 135.0);1056.3125;0.0042833660714285725;64;48;112;1
270;(135.0, 135.5);1070.142857142857;0.004001330357142857;67;45;112;1
271;(135.5, 136.0);1071.1929824561403;0.0041040614035087715;69;45;114;1
272;(136.0, 136.5);1070.3398058252428;0.004806533980582523;61;42;103;1
273;(136.5, 137.0);1003.5964912280701;0.0041097192982456135;70;44;114;1
274;(137.0, 137.5);901.6041666666666;0.0034388263888888897;100;44;144;1
275;(137.5, 138.0);870.7266666666667;0.0030925333333333333;107;43;150;1
276;(138.0, 138.5);874.2096774193549;0.003914274193548386;76;48;124;1
277;(138.5, 139.0);931.5940594059406;0.004745702970297028;58;43;101;1
278;(139.0, 139.5);938.6981132075472;0.004722226415094339;63;43;106;1
279;(139.5, 140.0);929.0648148148148;0.004460851851851852;66;42;108;1
280;(140.0, 140.5);882.2336448598131;0.004728532710280373;63;44;107;1
281;(140.5, 141.0);924.52;0.0047528399999999995;58;42;100;1
282;(141.0, 141.5);792.9207920792079;0.005035217821782176;66;35;101;1
283;(141.5, 142.0);761.53;0.00449564;63;37;100;1
284;(142.0, 142.5);969.4636363636364;0.004620063636363636;67;43;110;1
285;(142.5, 143.0);953.7129629629629;0.004588046296296295;64;44;108;1
286;(143.0, 143.5);935.5631067961165;0.0047998349514563115;60;43;103;1
287;(143.5, 144.0);927.4095238095238;0.004419990476190476;58;47;105;1
288;(144.0, 144.5);953.7596153846154;0.004771096153846153;66;38;104;1
289;(144.5, 145.0);932.8448275862069;0.004125879310344829;71;45;116;1
290;(145.0, 145.5);857.3235294117648;0.004574666666666666;61;41;102;1
291;(145.5, 146.0);837.2952380952381;0.004727390476190475;62;43;105;1
292;(146.0, 146.5);920.5242718446602;0.004607407766990291;62;41;103;1
293;(146.5, 147.0);852.7307692307693;0.004895490384615384;61;43;104;1
294;(147.0, 147.5);933.9207920792079;0.004847019801980198;60;41;101;1
295;(147.5, 148.0);952.7238095238096;0.004785619047619046;64;41;105;1
296;(148.0, 148.5);861.9893617021277;0.005045659574468083;59;35;94;1
297;(148.5, 149.0);875.7676767676768;0.004972565656565657;58;41;99;1
298;(149.0, 149.5);808.5904761904762;0.004364733333333333;62;43;105;1
299;(149.5, 150.0);932.9811320754717;0.004947103773584905;70;36;106;1
300;(150.0, 150.5);939.4636363636364;0.004406518181818181;60;50;110;1
301;(150.5, 151.0);870.0347826086957;0.0043273391304347805;65;50;115;1
302;(151.0, 151.5);859.4324324324324;0.004320027027027027;58;53;111;1
303;(151.5, 152.0);915.5428571428571;0.004550514285714286;57;48;105;1
304;(152.0, 152.5);887.2148760330579;0.004030264462809916;69;52;121;1
305;(152.5, 153.0);859.0330578512396;0.003959586776859503;67;54;121;1
306;(153.0, 153.5);865.4224137931035;0.004105353448275861;69;47;116;1
307;(153.5, 154.0);879.925925925926;0.004495185185185185;68;40;108;1
308;(154.0, 154.5);881.2293577981651;0.004188559633027522;64;45;109;1
309;(154.5, 155.0);823.6880733944954;0.004427651376146789;63;46;109;1
310;(155.0, 155.5);866.0083333333333;0.004442375;72;48;120;1
311;(155.5, 156.0);875.5535714285714;0.004430116071428571;68;44;112;1
312;(156.0, 156.5);884.377358490566;0.004533707547169809;56;50;106;1
313;(156.5, 157.0);825.4924242424242;0.0038321060606060623;79;53;132;1
314;(157.0, 157.5);891.7479674796748;0.003930829268292682;66;57;123;1
315;(157.5, 158.0);905.4324324324324;0.004323792792792792;62;49;111;1
316;(158.0, 158.5);881.8473282442748;0.0038606564885496166;73;58;131;1
317;(158.5, 159.0);890.0454545454545;0.004196890909090908;56;54;110;1
318;(159.0, 159.5);891.1526717557252;0.0036226412213740465;76;55;131;1
319;(159.5, 160.0);909.6065573770492;0.004051139344262293;65;57;122;1
320;(160.0, 160.5);904.6829268292682;0.0039076178861788624;64;59;123;1
321;(160.5, 161.0);888.3868613138686;0.0035179416058394152;79;58;137;1
322;(161.0, 161.5);925.6218487394958;0.004044882352941176;66;53;119;1
323;(161.5, 162.0);921.4580152671756;0.003807687022900763;69;62;131;1
324;(162.0, 162.5);922.0671641791045;0.0036383880597014914;58;76;134;1
325;(162.5, 163.0);907.2751677852349;0.0033209664429530187;73;76;149;1
326;(163.0, 163.5);989.674074074074;0.0036266740740740727;62;73;135;1
327;(163.5, 164.0);1005.6046511627907;0.0037820620155038756;55;74;129;1
328;(164.0, 164.5);939.0828025477707;0.002961280254777069;75;82;157;1
329;(164.5, 165.0);980.2164179104477;0.0037003582089552224;60;74;134;1
330;(165.0, 165.5);1025.2516556291391;0.0031319337748344366;77;74;151;1
331;(165.5, 166.0);987.0193548387097;0.0031823999999999984;81;74;155;1
332;(166.0, 166.5);991.0214285714286;0.0035683;71;69;140;1
333;(166.5, 167.0);997.1212121212121;0.0037728257575757557;60;72;132;1
334;(167.0, 167.5);981.4964028776978;0.003480330935251799;69;70;139;1
335;(167.5, 168.0);957.7417218543046;0.0032545430463576143;75;76;151;1
336;(168.0, 168.5);912.4031007751938;0.0038253100775193782;52;77;129;1
337;(168.5, 169.0);978.317880794702;0.003214066225165562;78;73;151;1
338;(169.0, 169.5);977.3257575757576;0.0037936969696969686;61;71;132;1
339;(169.5, 170.0);978.4492753623189;0.0035454420289855086;65;73;138;1
340;(170.0, 170.5);988.1111111111111;0.003477784722222221;71;73;144;1
341;(170.5, 171.0);991.24;0.0031981599999999994;83;67;150;1
342;(171.0, 171.5);965.463768115942;0.0035925652173913014;71;67;138;1
343;(171.5, 172.0);910.276119402985;0.003544134328358207;59;75;134;1
344;(172.0, 172.5);984.2816901408451;0.0035404647887323937;63;79;142;1
345;(172.5, 173.0);946.8904109589041;0.00321794520547945;63;83;146;1
346;(173.0, 173.5);944.2977099236641;0.0037452519083969434;47;84;131;1
347;(173.5, 174.0);944.1276595744681;0.00329396453900709;57;84;141;1
348;(174.0, 174.5);895.8290598290598;0.004078119658119658;58;59;117;1
349;(174.5, 175.0);911.2912621359224;0.004644252427184466;49;54;103;1
350;(175.0, 175.5);866.576;0.003874263999999998;67;58;125;1
351;(175.5, 176.0);880.4932432432432;0.003315851351351351;96;52;148;1
352;(176.0, 176.5);889.5620437956204;0.003640335766423357;82;55;137;1
353;(176.5, 177.0);891.7704918032787;0.003871254098360653;68;54;122;1
354;(177.0, 177.5);900.2627737226277;0.0036264671532846714;82;55;137;1
355;(177.5, 178.0);897.303448275862;0.003356855172413793;89;56;145;1
356;(178.0, 178.5);887.25;0.0037921212121212115;75;57;132;1
357;(178.5, 179.0);876.2692307692307;0.0034541846153846147;71;59;130;1
358;(179.0, 179.5);830.7898550724638;0.0035722971014492738;76;62;138;1
359;(179.5, 180.0);884.4186046511628;0.0036375968992248056;66;63;129;1
360;(180.0, 180.5);855.1129032258065;0.003978548387096774;64;60;124;1
361;(180.5, 181.0);881.1583333333333;0.003949691666666665;63;57;120;0
362;(181.0, 181.5);883.2932330827068;0.003713714285714282;69;64;133;0
363;(181.5, 182.0);910.703125;0.003612406249999999;68;60;128;0
364;(182.0, 182.5);911.7;0.003881876923076923;62;68;130;0
365;(182.5, 183.0);878.9798657718121;0.003292657718120804;79;70;149;0
366;(183.0, 183.5);908.6929133858267;0.003968212598425195;65;62;127;0
367;(183.5, 184.0);998.9469696969697;0.00353110606060606;71;61;132;0
368;(184.0, 184.5);1023.0;0.003776283582089553;72;62;134;0
369;(184.5, 185.0);1009.2;0.0037177384615384606;68;62;130;0
370;(185.0, 185.5);982.6616541353384;0.0037949699248120295;71;62;133;0
371;(185.5, 186.0);1012.9837398373984;0.0038814878048780486;70;53;123;0
372;(186.0, 186.5);918.0185185185185;0.004667324074074073;69;39;108;0
373;(186.5, 187.0);851.672131147541;0.003954622950819672;72;50;122;0
374;(187.0, 187.5);958.6315789473684;0.005036210526315787;68;27;95;0
375;(187.5, 188.0);905.6;0.004341878260869564;73;42;115;0
376;(188.0, 188.5);969.4725274725274;0.005366087912087912;69;22;91;0
377;(188.5, 189.0);926.6;0.004613979999999998;76;24;100;0
378;(189.0, 189.5);984.735632183908;0.005309885057471266;67;20;87;0
379;(189.5, 190.0);989.2631578947369;0.004994810526315786;68;27;95;0
380;(190.0, 190.5);964.3548387096774;0.005115795698924728;71;22;93;0
381;(190.5, 191.0);944.9247311827957;0.005306774193548388;73;20;93;0
382;(191.0, 191.5);1000.7849462365591;0.005265784946236556;73;20;93;0
383;(191.5, 192.0);1002.7682926829268;0.005863170731707318;65;17;82;0
384;(192.0, 192.5);1010.6666666666666;0.005544799999999996;71;19;90;0
385;(192.5, 193.0);961.1157894736842;0.005282136842105263;73;22;95;0
386;(193.0, 193.5);1002.9047619047619;0.005764047619047618;67;17;84;0
387;(193.5, 194.0);997.4333333333333;0.005314733333333332;69;21;90;0
388;(194.0, 194.5);888.6666666666666;0.004782098039215686;74;28;102;0
389;(194.5, 195.0);1014.7741935483871;0.005494526881720431;75;18;93;0
390;(195.0, 195.5);969.0224719101124;0.005386460674157304;67;22;89;0
391;(195.5, 196.0);1004.3;0.005265155555555556;73;17;90;0
392;(196.0, 196.5);985.1538461538462;0.005392197802197801;68;23;91;0
393;(196.5, 197.0);994.6551724137931;0.005733494252873562;68;19;87;0
394;(197.0, 197.5);961.2967032967033;0.005009725274725274;70;21;91;0
395;(197.5, 198.0);968.1170212765958;0.00519505319148936;75;19;94;0
396;(198.0, 198.5);926.0537634408602;0.005352344086021506;74;19;93;0
397;(198.5, 199.0);997.2613636363636;0.00537865909090909;71;17;88;0
398;(199.0, 199.5);990.0444444444445;0.005459344444444443;70;20;90;0
399;(199.5, 200.0);995.1011235955057;0.005208752808988765;70;19;89;0
400;(200.0, 200.5);1004.8023255813954;0.005922418604651161;71;15;86;0
401;(200.5, 201.0);1027.7261904761904;0.005699833333333334;69;15;84;0
402;(201.0, 201.5);977.2421052631579;0.005294736842105265;73;22;95;0
403;(201.5, 202.0);902.7204301075269;0.005113247311827956;69;24;93;0
404;(202.0, 202.5);998.5978260869565;0.00489033695652174;74;18;92;0
405;(202.5, 203.0);979.2826086956521;0.005518652173913044;74;18;92;0
406;(203.0, 203.5);994.2873563218391;0.005744471264367817;70;17;87;0
407;(203.5, 204.0);992.8571428571429;0.0051514404761904735;68;16;84;0
408;(204.0, 204.5);1003.6091954022988;0.005520862068965518;72;15;87;0
409;(204.5, 205.0);990.6818181818181;0.005904795454545455;71;17;88;0
410;(205.0, 205.5);954.468085106383;0.005144021276595744;72;22;94;0
411;(205.5, 206.0);936.554347826087;0.005281032608695652;72;20;92;0
412;(206.0, 206.5);989.4705882352941;0.005625847058823529;69;16;85;0
413;(206.5, 207.0);1011.6022727272727;0.005817534090909091;71;17;88;0
414;(207.0, 207.5);975.2359550561798;0.005615808988764045;71;18;89;0
415;(207.5, 208.0);972.0222222222222;0.005442155555555556;73;17;90;0
416;(208.0, 208.5);979.6543209876543;0.006140851851851853;66;15;81;0
417;(208.5, 209.0);1011.3103448275862;0.0052997471264367825;72;15;87;0
418;(209.0, 209.5);924.2604166666666;0.0046530416666666664;75;21;96;0
419;(209.5, 210.0);983.0975609756098;0.00592770731707317;65;17;82;0
420;(210.0, 210.5);986.1276595744681;0.005508468085106381;76;18;94;0
421;(210.5, 211.0);1000.964705882353;0.005768917647058826;70;15;85;0
422;(211.0, 211.5);983.5903614457832;0.005093614457831327;66;17;83;0
423;(211.5, 212.0);967.3444444444444;0.005853411111111113;69;21;90;0
424;(212.0, 212.5);995.5444444444445;0.0054643333333333315;73;17;90;0
425;(212.5, 213.0);953.7173913043479;0.00526866304347826;70;22;92;0
426;(213.0, 213.5);931.0860215053764;0.005211032258064517;73;20;93;0
427;(213.5, 214.0);1005.8235294117648;0.005256894117647058;69;16;85;0
428;(214.0, 214.5);952.2873563218391;0.005205321839080457;68;19;87;0
429;(214.5, 215.0);977.7111111111111;0.005675166666666666;69;21;90;0
430;(215.0, 215.5);1006.5568181818181;0.005346943181818182;72;16;88;0
431;(215.5, 216.0);994.8588235294118;0.0057956;68;17;85;0
432;(216.0, 216.5);963.1279069767442;0.0056350813953488345;67;19;86;0
433;(216.5, 217.0);892.1188118811881;0.0047569009900990085;75;26;101;0
434;(217.0, 217.5);1004.9642857142857;0.005687892857142857;69;15;84;0
435;(217.5, 218.0);993.551724137931;0.005774827586206895;71;16;87;0
436;(218.0, 218.5);979.1585365853658;0.0058803048780487815;64;18;82;0
437;(218.5, 219.0);1005.8636363636364;0.005278352272727273;71;17;88;0
438;(219.0, 219.5);967.5824175824176;0.005622483516483513;71;20;91;0
439;(219.5, 220.0);994.8409090909091;0.005569534090909091;71;17;88;0
440;(220.0, 220.5);964.6888888888889;0.005383888888888889;70;20;90;0
441;(220.5, 221.0);951.0340909090909;0.005124329545454545;70;18;88;0
442;(221.0, 221.5);1002.0674157303371;0.005758662921348316;72;17;89;0
443;(221.5, 222.0);972.7209302325581;0.005655627906976743;67;19;86;0
444;(222.0, 222.5);995.5294117647059;0.005894247058823529;67;18;85;0
445;(222.5, 223.0);974.2197802197802;0.005262681318681318;73;18;91;0
446;(223.0, 223.5);986.3678160919541;0.0058638620689655165;70;17;87;0
447;(223.5, 224.0);971.2150537634409;0.0052486881720430105;66;27;93;0
448;(224.0, 224.5);885.5982142857143;0.004382330357142856;81;31;112;0
449;(224.5, 225.0);972.6516853932584;0.005138595505617977;66;23;89;0
450;(225.0, 225.5);1007.1777777777778;0.0054209777777777775;70;20;90;0
451;(225.5, 226.0);961.2840909090909;0.004942329545454545;70;18;88;0
452;(226.0, 226.5);978.6144578313254;0.006061638554216869;64;19;83;0
453;(226.5, 227.0);991.8901098901099;0.005377659340659341;74;17;91;0
454;(227.0, 227.5);1002.9625;0.006223675000000003;65;15;80;0
455;(227.5, 228.0);967.4148936170212;0.005044425531914893;75;19;94;0
456;(228.0, 228.5);920.5894736842105;0.005095505263157897;74;21;95;0
457;(228.5, 229.0);994.3294117647059;0.005739329411764705;67;18;85;0
458;(229.0, 229.5);991.9058823529411;0.005577976470588236;68;17;85;0
459;(229.5, 230.0);998.9666666666667;0.005569733333333333;71;19;90;0
460;(230.0, 230.5);1010.735632183908;0.00570242528735632;70;17;87;0
461;(230.5, 231.0);1010.3333333333334;0.0057230919540229895;68;19;87;0
462;(231.0, 231.5);974.1494252873563;0.005563505747126436;69;18;87;0
463;(231.5, 232.0);891.7731958762887;0.004811958762886598;74;23;97;0
464;(232.0, 232.5);976.4827586206897;0.005648264367816092;70;17;87;0
465;(232.5, 233.0);923.6404494382023;0.00565461797752809;69;20;89;0
466;(233.0, 233.5);984.7865168539325;0.005459202247191011;69;20;89;0
467;(233.5, 234.0);990.8604651162791;0.005847523255813953;68;18;86;0
468;(234.0, 234.5);999.7341772151899;0.005710227848101268;63;16;79;0
469;(234.5, 235.0);976.3;0.005664211111111113;74;16;90;0
470;(235.0, 235.5);960.989010989011;0.005596626373626376;72;19;91;0
471;(235.5, 236.0);949.2808988764045;0.005507123595505619;72;17;89;0
472;(236.0, 236.5);1175.3909090909092;0.004541636363636362;69;41;110;0
473;(236.5, 237.0);1068.484126984127;0.003934984126984127;66;60;126;0
474;(237.0, 237.5);917.5813953488372;0.0039076744186046525;75;54;129;0
475;(237.5, 238.0);944.6940298507462;0.003420044776119402;71;63;134;0
476;(238.0, 238.5);995.5637583892617;0.0032908724832214765;65;84;149;0
477;(238.5, 239.0);1005.88125;0.0031333;76;84;160;0
478;(239.0, 239.5);952.5897435897435;0.0030268910256410248;69;87;156;0
479;(239.5, 240.0);1015.8169934640523;0.003283928104575163;73;80;153;0
480;(240.0, 240.5);1016.8421052631579;0.003289368421052629;70;82;152;0
481;(240.5, 241.0);1042.8333333333333;0.003339362318840581;65;73;138;0
482;(241.0, 241.5);1016.3243243243244;0.003320060810810809;68;80;148;1
483;(241.5, 242.0);977.3741935483871;0.003164425806451611;71;84;155;1
484;(242.0, 242.5);1048.2481751824816;0.0035989197080291955;65;72;137;1
485;(242.5, 243.0);996.8076923076923;0.003145339743589742;77;79;156;1
486;(243.0, 243.5);979.1532846715329;0.003555087591240876;64;73;137;1
487;(243.5, 244.0);1043.9366197183099;0.003372140845070421;70;72;142;1
488;(244.0, 244.5);1024.3591549295775;0.003524246478873237;69;73;142;1
489;(244.5, 245.0);1019.931506849315;0.003427335616438357;72;74;146;1
490;(245.0, 245.5);1011.7173913043479;0.0036456521739130416;62;76;138;1
491;(245.5, 246.0);1028.9935483870968;0.0031077161290322575;81;74;155;1
492;(246.0, 246.5);1002.2746478873239;0.0035018661971830977;66;76;142;1
493;(246.5, 247.0);984.1363636363636;0.0032415909090909075;74;80;154;1
494;(247.0, 247.5);995.6183206106871;0.0037890763358778613;57;74;131;1
495;(247.5, 248.0);998.6883116883117;0.003146902597402596;77;77;154;1
496;(248.0, 248.5);1043.23125;0.0030168437499999987;81;79;160;1
497;(248.5, 249.0);1037.9466666666667;0.003260166666666667;70;80;150;1
498;(249.0, 249.5);1042.476821192053;0.003249337748344369;71;80;151;1
499;(249.5, 250.0);1050.543624161074;0.0033535570469798662;70;79;149;1
500;(250.0, 250.5);1013.4113475177305;0.0035073758865248224;60;81;141;1
501;(250.5, 251.0);1008.7862068965517;0.0033582551724137912;65;80;145;1
502;(251.0, 251.5);1041.0472972972973;0.0034040878378378374;65;83;148;1
503;(251.5, 252.0);1047.7602739726028;0.003331602739726025;68;78;146;1
504;(252.0, 252.5);1032.7571428571428;0.0036018214285714265;54;86;140;1
505;(252.5, 253.0);1065.2676056338028;0.003468394366197181;67;75;142;1
506;(253.0, 253.5);1059.8931297709923;0.0038094809160305323;54;77;131;1
507;(253.5, 254.0);1062.8721804511279;0.0036814210526315773;57;76;133;1
508;(254.0, 254.5);984.6976744186046;0.003888263565891473;53;76;129;1
509;(254.5, 255.0);1028.186274509804;0.004884696078431371;50;52;102;1
510;(255.0, 255.5);1036.3490566037735;0.004431292452830188;55;51;106;1
511;(255.5, 256.0);961.1610169491526;0.0041407711864406786;71;47;118;1
512;(256.0, 256.5);1003.219512195122;0.0038650162601626004;74;49;123;1
513;(256.5, 257.0);1041.3307086614172;0.0037545039370078734;76;51;127;1
514;(257.0, 257.5);1034.9772727272727;0.003730742424242423;80;52;132;1
515;(257.5, 258.0);975.1370967741935;0.0039342258064516125;65;59;124;1
516;(258.0, 258.5);978.184;0.0038204399999999987;68;57;125;1
517;(258.5, 259.0);983.5151515151515;0.004924575757575758;53;46;99;1
518;(259.0, 259.5);997.9215686274509;0.0046543627450980375;58;44;102;1
519;(259.5, 260.0);969.3980582524272;0.004778310679611652;63;40;103;1
520;(260.0, 260.5);865.2786885245902;0.0040091885245901624;84;38;122;1
521;(260.5, 261.0);869.9814814814815;0.0046213888888888876;71;37;108;1
522;(261.0, 261.5);880.8703703703703;0.004479759259259257;74;34;108;1
523;(261.5, 262.0);818.203125;0.0037714687499999988;83;45;128;1
524;(262.0, 262.5);858.6465517241379;0.004191077586206897;81;35;116;1
525;(262.5, 263.0);839.0555555555555;0.004616037037037036;71;37;108;1
526;(263.0, 263.5);853.5206611570248;0.004038545454545454;84;37;121;1
527;(263.5, 264.0);894.9230769230769;0.005417098901098901;55;36;91;1
528;(264.0, 264.5);852.1909090909091;0.004426318181818182;64;46;110;1
529;(264.5, 265.0);830.8653846153846;0.004887125000000001;58;46;104;1
530;(265.0, 265.5);810.4594594594595;0.00438318018018018;67;44;111;1
531;(265.5, 266.0);810.433628318584;0.004416283185840707;64;49;113;1
532;(266.0, 266.5);858.4752475247525;0.004709336633663365;58;43;101;1
533;(266.5, 267.0);843.3333333333334;0.004248699999999999;69;51;120;1
534;(267.0, 267.5);828.7264150943396;0.004674056603773583;60;46;106;1
535;(267.5, 268.0);846.8317757009346;0.004688046728971961;61;46;107;1
536;(268.0, 268.5);829.3333333333334;0.004244333333333333;65;52;117;1
537;(268.5, 269.0);839.2095238095238;0.004748476190476191;59;46;105;1
538;(269.0, 269.5);793.8083333333333;0.003983958333333332;67;53;120;1
539;(269.5, 270.0);839.7232142857143;0.004258366071428573;61;51;112;1
540;(270.0, 270.5);842.3162393162393;0.003945965811965812;67;50;117;1
541;(270.5, 271.0);861.5;0.0047094230769230755;57;47;104;1
542;(271.0, 271.5);853.5818181818182;0.004394681818181818;64;46;110;1
543;(271.5, 272.0);877.3245614035088;0.004461307017543859;65;49;114;1
544;(272.0, 272.5);863.2897196261682;0.004569214953271026;60;47;107;1
545;(272.5, 273.0);824.5752212389381;0.004083176991150441;62;51;113;1
546;(273.0, 273.5);771.7168141592921;0.004458469026548673;64;49;113;1
547;(273.5, 274.0);851.0555555555555;0.00461775;64;44;108;1
548;(274.0, 274.5);793.8144329896908;0.004933144329896906;52;45;97;1
549;(274.5, 275.0);883.5982142857143;0.004277366071428571;72;40;112;1
550;(275.0, 275.5);787.2522522522522;0.004338414414414413;63;48;111;1
551;(275.5, 276.0);796.9411764705883;0.004686009803921569;59;43;102;1
552;(276.0, 276.5);857.7383177570093;0.004640850467289718;66;41;107;1
553;(276.5, 277.0);818.6890756302521;0.004000067226890755;68;51;119;1
554;(277.0, 277.5);852.8272727272728;0.004625281818181817;62;48;110;1
555;(277.5, 278.0);895.504761904762;0.0044758952380952385;62;43;105;1
556;(278.0, 278.5);867.4363636363636;0.004451563636363636;63;47;110;1
557;(278.5, 279.0);866.6168224299065;0.004560962616822429;61;46;107;1
558;(279.0, 279.5);835.9545454545455;0.004362327272727273;65;45;110;1
559;(279.5, 280.0);836.0754716981132;0.004679971698113206;63;43;106;1
560;(280.0, 280.5);772.0;0.0046811538461538444;62;42;104;1
561;(280.5, 281.0);820.6140350877193;0.00420742105263158;65;49;114;1
562;(281.0, 281.5);879.2056074766355;0.004756028037383175;60;47;107;1
563;(281.5, 282.0);885.362831858407;0.004285088495575223;66;47;113;1
564;(282.0, 282.5);835.6727272727272;0.004605981818181818;63;47;110;1
565;(282.5, 283.0);874.7068965517242;0.004145258620689655;68;48;116;1
566;(283.0, 283.5);850.1619047619048;0.004648028571428569;62;43;105;1
567;(283.5, 284.0);885.2051282051282;0.004224076923076925;69;48;117;1
568;(284.0, 284.5);852.9243697478992;0.0040366302521008405;68;51;119;1
569;(284.5, 285.0);898.3615384615384;0.003747215384615382;63;67;130;1
570;(285.0, 285.5);919.2777777777778;0.003937650793650792;61;65;126;1
571;(285.5, 286.0);959.4580152671756;0.003740824427480915;63;68;131;1
572;(286.0, 286.5);946.9850746268656;0.003688000000000001;67;67;134;1
573;(286.5, 287.0);960.0229007633587;0.0038263053435114492;64;67;131;1
574;(287.0, 287.5);948.7142857142857;0.0038831507936507924;59;67;126;1
575;(287.5, 288.0);961.3700787401575;0.00391799212598425;60;67;127;1
576;(288.0, 288.5);918.9230769230769;0.0033679440559440544;73;70;143;1
577;(288.5, 289.0);984.780303030303;0.0035907348484848483;67;65;132;1
578;(289.0, 289.5);948.4335664335664;0.003432062937062935;72;71;143;1
579;(289.5, 290.0);930.0909090909091;0.0034992027972027963;70;73;143;1
580;(290.0, 290.5);940.2291666666666;0.0034044236111111107;76;68;144;1
581;(290.5, 291.0);955.2907801418439;0.00355191489361702;72;69;141;1
582;(291.0, 291.5);961.2089552238806;0.003695231343283583;66;68;134;1
583;(291.5, 292.0);884.0942028985507;0.0034998043478260852;66;72;138;1
584;(292.0, 292.5);947.2720588235294;0.003442242647058822;68;68;136;1
585;(292.5, 293.0);925.4233576642335;0.003579627737226276;67;70;137;1
586;(293.0, 293.5);949.6838235294117;0.0034998749999999995;69;67;136;1
587;(293.5, 294.0);943.2330827067669;0.003787556390977441;64;69;133;1
588;(294.0, 294.5);931.2357142857143;0.003534064285714281;68;72;140;1
589;(294.5, 295.0);924.5483870967741;0.0032189354838709668;73;82;155;1
590;(295.0, 295.5);887.2176870748299;0.0032608095238095213;54;93;147;1
591;(295.5, 296.0);895.1760563380282;0.0035233450704225348;55;87;142;1
592;(296.0, 296.5);906.3701298701299;0.003185305194805194;66;88;154;1
593;(296.5, 297.0);912.6928571428572;0.0035684285714285696;53;87;140;1
594;(297.0, 297.5);887.25;0.0033767430555555534;55;89;144;1
595;(297.5, 298.0);844.7434210526316;0.003254144736842103;58;94;152;1
596;(298.0, 298.5);861.6712328767123;0.0031750410958904097;55;91;146;1
597;(298.5, 299.0);794.8595041322315;0.0041470330578512364;56;65;121;1
598;(299.0, 299.5);750.2962962962963;0.0035157629629629624;66;69;135;1
599;(299.5, 300.0);791.7333333333333;0.0032495933333333326;90;60;150;1
600;(300.0, 300.5);841.7793103448275;0.0034582896551724122;82;63;145;1
601;(300.5, 301.0);816.5579710144928;0.0035635652173913054;73;65;138;1
602;(301.0, 301.5);836.0656934306569;0.0036198686131386857;75;62;137;0
603;(301.5, 302.0);877.0;0.00406276984126984;58;68;126;0
604;(302.0, 302.5);908.3828125;0.003795624999999998;65;63;128;0
605;(302.5, 303.0);861.8840579710145;0.0034318115942028973;70;68;138;0
606;(303.0, 303.5);868.7016129032259;0.00395464516129032;60;64;124;0
607;(303.5, 304.0);892.7741935483871;0.003847096774193546;64;60;124;0
608;(304.0, 304.5);924.139344262295;0.004048352459016394;62;60;122;0
609;(304.5, 305.0);885.0;0.003609519083969464;65;66;131;0
610;(305.0, 305.5);882.4296875;0.003818390625000001;65;63;128;0
611;(305.5, 306.0);769.7706422018349;0.004627266055045868;56;53;109;0
612;(306.0, 306.5);776.7454545454545;0.004400309090909088;68;42;110;0
613;(306.5, 307.0);719.7777777777778;0.004499898148148144;73;35;108;0
614;(307.0, 307.5);762.8461538461538;0.005392560439560439;62;29;91;0
615;(307.5, 308.0);816.7916666666666;0.005189166666666669;68;28;96;0
616;(308.0, 308.5);777.2736842105263;0.005205357894736842;67;28;95;0
617;(308.5, 309.0);777.5208333333334;0.004991406250000001;64;32;96;0
618;(309.0, 309.5);807.2083333333334;0.0051339583333333315;63;33;96;0
619;(309.5, 310.0);798.2717391304348;0.005047010869565216;67;25;92;0
620;(310.0, 310.5);769.6458333333334;0.0051840312499999985;66;30;96;0
621;(310.5, 311.0);754.0392156862745;0.004610362745098042;76;26;102;0
622;(311.0, 311.5);810.3823529411765;0.004789823529411763;66;36;102;0
623;(311.5, 312.0);887.5079365079365;0.0038521349206349204;66;60;126;0
624;(312.0, 312.5);810.8495575221239;0.004348619469026548;64;49;113;0
625;(312.5, 313.0);948.0;0.004383954545454545;60;50;110;0
626;(313.0, 313.5);881.7753623188406;0.003402797101449275;79;59;138;0
627;(313.5, 314.0);950.9918032786885;0.004099901639344262;67;55;122;0
628;(314.0, 314.5);860.4609375;0.0036659843749999995;72;56;128;0
629;(314.5, 315.0);886.08;0.003875575999999999;69;56;125;0
630;(315.0, 315.5);816.8350515463917;0.004898381443298967;63;34;97;0
631;(315.5, 316.0);834.97;0.0046799499999999996;74;26;100;0
632;(316.0, 316.5);845.875;0.005463397727272725;64;24;88;0
633;(316.5, 317.0);834.7692307692307;0.005477747252747253;71;20;91;0
634;(317.0, 317.5);833.9042553191489;0.005279585106382979;68;26;94;0
635;(317.5, 318.0);818.2526315789473;0.0050271263157894725;71;24;95;0
636;(318.0, 318.5);769.5555555555555;0.004140170940170941;73;44;117;0
637;(318.5, 319.0);832.4273504273505;0.004150128205128204;68;49;117;0
638;(319.0, 319.5);832.3660714285714;0.0043914821428571406;72;40;112;0
639;(319.5, 320.0);833.3564356435644;0.004726851485148515;66;35;101;0
640;(320.0, 320.5);929.53;0.00484022;68;32;100;0
641;(320.5, 321.0);971.0526315789474;0.005323936842105263;71;24;95;0
642;(321.0, 321.5);966.1789473684211;0.005071368421052631;66;29;95;0
643;(321.5, 322.0);873.8448275862069;0.00425546551724138;78;38;116;0
644;(322.0, 322.5);930.5478260869565;0.004344965217391302;66;49;115;0
645;(322.5, 323.0);1045.1404958677685;0.004101355371900827;70;51;121;0
646;(323.0, 323.5);984.5271317829457;0.003515542635658914;72;57;129;0
647;(323.5, 324.0);995.2682926829268;0.00402213008130081;66;57;123;0
648;(324.0, 324.5);954.9166666666666;0.005071958333333333;68;28;96;0
649;(324.5, 325.0);923.2075471698113;0.004525849056603772;71;35;106;0
650;(325.0, 325.5);993.2436974789916;0.004076865546218486;71;48;119;0
651;(325.5, 326.0);1001.4202898550725;0.003537760869565216;75;63;138;0
652;(326.0, 326.5);978.2148760330579;0.004120049586776859;72;49;121;0
653;(326.5, 327.0);939.7777777777778;0.004184461538461536;69;48;117;0
654;(327.0, 327.5);904.78;0.004942239999999998;72;28;100;0
655;(327.5, 328.0);957.0842105263158;0.005211084210526315;65;30;95;0
656;(328.0, 328.5);949.7358490566038;0.004723971698113207;70;36;106;0
657;(328.5, 329.0);1003.7204301075269;0.005267118279569891;69;24;93;0
658;(329.0, 329.5);885.4854368932039;0.004758941747572818;72;31;103;0
659;(329.5, 330.0);959.31;0.0046489999999999995;75;25;100;0
660;(330.0, 330.5);974.2307692307693;0.005438153846153845;68;23;91;0
661;(330.5, 331.0);972.9891304347826;0.00548541304347826;69;23;92;0
662;(331.0, 331.5);965.9795918367347;0.004517112244897958;71;27;98;0
663;(331.5, 332.0);981.8023255813954;0.005945953488372093;67;19;86;0
664;(332.0, 332.5);976.0194174757281;0.004702067961165046;68;35;103;0
665;(332.5, 333.0);965.312;0.0039232159999999985;72;53;125;0
666;(333.0, 333.5);886.69;0.00486885;78;22;100;0
667;(333.5, 334.0);964.1447368421053;0.006271144736842105;58;18;76;0
668;(334.0, 334.5);985.4105263157895;0.005314368421052632;76;19;95;0
669;(334.5, 335.0);966.5494505494505;0.005480571428571426;72;19;91;0
670;(335.0, 335.5);963.5568181818181;0.005528136363636364;68;20;88;0
671;(335.5, 336.0);972.0674157303371;0.005632685393258423;70;19;89;0
672;(336.0, 336.5);994.2261904761905;0.005696821428571427;67;17;84;0
673;(336.5, 337.0);886.3921568627451;0.004894313725490197;77;25;102;0
674;(337.0, 337.5);962.635294117647;0.005394729411764705;66;19;85;0
675;(337.5, 338.0);995.8295454545455;0.0055634204545454554;74;14;88;0
676;(338.0, 338.5);951.9186046511628;0.005706872093023256;68;18;86;0
677;(338.5, 339.0);968.953488372093;0.005760523255813953;70;16;86;0
678;(339.0, 339.5);984.2;0.0058510588235294115;70;15;85;0
679;(339.5, 340.0);942.4888888888889;0.005075566666666665;70;20;90;0
680;(340.0, 340.5);932.2650602409639;0.005754216867469878;63;20;83;0
681;(340.5, 341.0);908.968085106383;0.005235776595744681;72;22;94;0
682;(341.0, 341.5);1002.4615384615385;0.0064830128205128216;66;12;78;0
683;(341.5, 342.0);991.5116279069767;0.005719348837209304;71;15;86;0
684;(342.0, 342.5);956.0;0.005602629213483145;67;22;89;0
685;(342.5, 343.0);950.4430379746835;0.0058830632911392395;58;21;79;0
686;(343.0, 343.5);828.7058823529412;0.01236226470588235;20;14;34;0
687;(343.5, 344.0);870.5882352941177;0.009890215686274512;33;18;51;0
688;(344.0, 344.5);814.7462686567164;0.007488298507462686;47;20;67;0
689;(344.5, 345.0);870.7164179104477;0.00679773134328358;46;21;67;0
690;(345.0, 345.5);940.8333333333334;0.006106666666666666;59;19;78;0
691;(345.5, 346.0);924.9818181818182;0.008908690909090907;40;15;55;0
692;(346.0, 346.5);974.6260869565217;0.004195669565217391;100;15;115;0
693;(346.5, 347.0);1013.696682464455;0.002414056872037913;164;47;211;0
694;(347.0, 347.5);891.7612903225806;0.0031356967741935486;117;38;155;0
695;(347.5, 348.0);840.4787234042553;0.004901925531914894;71;23;94;0
696;(348.0, 348.5);826.4536082474227;0.005089876288659792;75;22;97;0
697;(348.5, 349.0);889.2613636363636;0.0057638068181818155;71;17;88;0
698;(349.0, 349.5);885.6585365853658;0.005807353658536584;66;16;82;0
699;(349.5, 350.0);862.4111111111112;0.0052014222222222205;68;22;90;0
700;(350.0, 350.5);900.7222222222222;0.005472344444444443;72;18;90;0
701;(350.5, 351.0);913.7176470588236;0.00584570588235294;69;16;85;0
702;(351.0, 351.5);897.6024096385543;0.005853036144578314;66;17;83;0
703;(351.5, 352.0);820.4226804123712;0.005080422680412372;75;22;97;0
704;(352.0, 352.5);904.7790697674419;0.005418697674418604;68;18;86;0
705;(352.5, 353.0);924.8651685393259;0.005747820224719103;73;16;89;0
706;(353.0, 353.5);928.4404761904761;0.005324595238095237;68;16;84;0
707;(353.5, 354.0);948.4588235294118;0.005788399999999998;69;16;85;0
708;(354.0, 354.5);924.8823529411765;0.0057457411764705885;69;16;85;0
709;(354.5, 355.0);930.3846153846154;0.005508703296703294;69;22;91;0
710;(355.0, 355.5);905.7956989247311;0.004981677419354839;71;22;93;0
711;(355.5, 356.0);858.6666666666666;0.005173225806451613;71;22;93;0
712;(356.0, 356.5);1015.7029702970297;0.004967861386138611;70;31;101;0
713;(356.5, 357.0);1087.0;0.00387058870967742;71;53;124;0
714;(357.0, 357.5);937.2772277227723;0.004957940594059404;70;31;101;0
715;(357.5, 358.0);921.3820224719101;0.005489382022471912;70;19;89;0
716;(358.0, 358.5);963.4235294117647;0.005872894117647057;68;17;85;0
717;(358.5, 359.0);960.7191011235955;0.005436651685393257;68;21;89;0
718;(359.0, 359.5);900.3936170212766;0.005238755319148933;73;21;94;0
719;(359.5, 360.0);937.2065217391304;0.005033880434782606;71;21;92;0
720;(360.0, 360.5);965.9010989010989;0.00543164835164835;71;20;91;0
721;(360.5, 361.0);961.1264367816092;0.005810264367816093;67;20;87;0
722;(361.0, 361.5);978.2235294117647;0.005424752941176471;68;17;85;1
723;(361.5, 362.0);952.4555555555555;0.0059432555555555535;72;18;90;1
724;(362.0, 362.5);1086.8245614035088;0.00439028947368421;73;41;114;1
725;(362.5, 363.0);1065.8992248062016;0.0036908759689922464;70;59;129;1
726;(363.0, 363.5);1042.378787878788;0.0037455378787878777;79;53;132;1
727;(363.5, 364.0);1106.5070422535211;0.0034572253521126762;72;70;142;1
728;(364.0, 364.5);1106.913669064748;0.0035971510791366905;71;68;139;1
729;(364.5, 365.0);1105.1608391608393;0.003437111888111888;74;69;143;1
730;(365.0, 365.5);1088.029197080292;0.0036370802919708;66;71;137;1
731;(365.5, 366.0);1104.2344827586207;0.003473696551724136;76;69;145;1
732;(366.0, 366.5);1107.9389312977098;0.0036553511450381653;64;67;131;1
733;(366.5, 367.0);1062.1006289308177;0.003075207547169809;88;71;159;1
734;(367.0, 367.5);1124.0808823529412;0.003666955882352942;71;65;136;1
735;(367.5, 368.0);1113.8958333333333;0.0034737986111111085;75;69;144;1
736;(368.0, 368.5);1092.0526315789473;0.00375766917293233;61;72;133;1
737;(368.5, 369.0);1135.8287671232877;0.0033495410958904103;77;69;146;1
738;(369.0, 369.5);1133.9928057553957;0.003551007194244602;71;68;139;1
739;(369.5, 370.0);1113.4347826086957;0.0035023985507246372;69;69;138;1
740;(370.0, 370.5);1124.4761904761904;0.0033395714285714287;76;71;147;1
741;(370.5, 371.0);1075.655844155844;0.003158389610389609;82;72;154;1
742;(371.0, 371.5);1129.887323943662;0.0035214084507042254;73;69;142;1
743;(371.5, 372.0);1110.7391304347825;0.0036200797101449272;70;68;138;1
744;(372.0, 372.5);1110.7241379310344;0.0034016482758620664;75;70;145;1
745;(372.5, 373.0);1104.1818181818182;0.0037231969696969684;65;67;132;1
746;(373.0, 373.5);1097.5328467153286;0.0035657810218978057;69;68;137;1
747;(373.5, 374.0);1131.0337837837837;0.003403662162162161;77;71;148;1
748;(374.0, 374.5);1061.993865030675;0.0029213558282208587;84;79;163;1
749;(374.5, 375.0);1064.2517482517483;0.0034524755244755203;65;78;143;1
750;(375.0, 375.5);1096.909090909091;0.0033759580419580404;66;77;143;1
751;(375.5, 376.0);1084.751677852349;0.003298355704697985;74;75;149;1
752;(376.0, 376.5);1099.6827586206896;0.003389951724137931;69;76;145;1
753;(376.5, 377.0);1099.0071428571428;0.003501707142857141;64;76;140;1
754;(377.0, 377.5);1039.6887417218543;0.0032243774834437096;66;85;151;1
755;(377.5, 378.0);1009.45;0.0030824437499999994;69;91;160;1
756;(378.0, 378.5);956.9426751592357;0.003082108280254775;63;94;157;1
757;(378.5, 379.0);1033.4968944099378;0.0030497080745341613;75;86;161;1
758;(379.0, 379.5);1062.1748251748252;0.003474440559440557;63;80;143;1
759;(379.5, 380.0);1096.2702702702702;0.0032907770270270247;77;71;148;1
760;(380.0, 380.5);1087.0070422535211;0.0034465422535211255;66;76;142;1
761;(380.5, 381.0);1062.6644295302012;0.0033249395973154335;71;78;149;1
762;(381.0, 381.5);1089.611111111111;0.0034739861111111096;67;77;144;1
763;(381.5, 382.0);964.3076923076923;0.0030584423076923067;67;89;156;1
764;(382.0, 382.5);976.3098591549295;0.0034406338028168996;51;91;142;1
765;(382.5, 383.0);1030.6637168141592;0.004381902654867256;69;44;113;1
766;(383.0, 383.5);1051.1743119266055;0.004548633027522936;60;49;109;1
767;(383.5, 384.0);1025.874074074074;0.003642733333333331;81;54;135;1
768;(384.0, 384.5);1026.4016393442623;0.004064155737704916;73;49;122;1
769;(384.5, 385.0);932.472;0.004017119999999999;77;48;125;1
770;(385.0, 385.5);955.7538461538461;0.003723815384615384;84;46;130;1
771;(385.5, 386.0);966.390977443609;0.0035885338345864656;77;56;133;1
772;(386.0, 386.5);1037.9917355371902;0.004134760330578512;78;43;121;1
773;(386.5, 387.0);948.4809160305343;0.0037533511450381675;85;46;131;1
774;(387.0, 387.5);912.3565217391305;0.0042754260869565215;73;42;115;1
775;(387.5, 388.0);873.6538461538462;0.004832913461538462;71;33;104;1
776;(388.0, 388.5);967.8018867924528;0.004573443396226415;66;40;106;1
777;(388.5, 389.0);959.704347826087;0.0042968347826086925;68;47;115;1
778;(389.0, 389.5);944.59375;0.0037309062500000003;76;52;128;1
779;(389.5, 390.0);994.6511627906976;0.0039002790697674414;73;56;129;1
780;(390.0, 390.5);969.4876033057851;0.003915347107438016;67;54;121;1
781;(390.5, 391.0);1068.892561983471;0.004023735537190081;70;51;121;1
782;(391.0, 391.5);1027.946153846154;0.003895400000000001;71;59;130;1
783;(391.5, 392.0);1035.4621848739496;0.004254924369747897;64;55;119;1
784;(392.0, 392.5);1023.439024390244;0.004023569105691057;66;57;123;1
785;(392.5, 393.0);934.2954545454545;0.003671628787878786;75;57;132;1
786;(393.0, 393.5);920.0820895522388;0.0036038880597014916;77;57;134;1
787;(393.5, 394.0);1009.5748031496063;0.0036504645669291303;68;59;127;1
788;(394.0, 394.5);975.4153846153846;0.003824323076923077;69;61;130;1
789;(394.5, 395.0);947.2926829268292;0.003938040650406502;69;54;123;1
790;(395.0, 395.5);924.1652892561983;0.004070330578512396;70;51;121;1
791;(395.5, 396.0);1018.6198347107438;0.003917504132231406;68;53;121;1
792;(396.0, 396.5);1068.9923076923078;0.0038536692307692315;69;61;130;1
793;(396.5, 397.0);966.1007194244604;0.0035064964028776982;72;67;139;1
794;(397.0, 397.5);1037.8625954198474;0.0038365648854961822;68;63;131;1
795;(397.5, 398.0);1059.7751937984497;0.0038007829457364323;72;57;129;1
796;(398.0, 398.5);932.491935483871;0.0038684516129032253;67;57;124;1
797;(398.5, 399.0);1050.4920634920634;0.00391174603174603;72;54;126;1
798;(399.0, 399.5);1026.5;0.0036602279411764695;72;64;136;1
799;(399.5, 400.0);1082.8951612903227;0.003945443548387096;66;58;124;1
800;(400.0, 400.5);1015.8432835820895;0.003615246268656715;71;63;134;1
801;(400.5, 401.0);988.5036496350365;0.003581007299270073;74;63;137;1
802;(401.0, 401.5);1003.5454545454545;0.004009669421487604;63;58;121;1
803;(401.5, 402.0);981.7751937984497;0.00379313953488372;71;58;129;1
804;(402.0, 402.5);1018.5952380952381;0.00398722222222222;71;55;126;1
805;(402.5, 403.0);1013.5952380952381;0.0038837142857142846;68;58;126;1
806;(403.0, 403.5);1007.5409836065573;0.003942934426229508;72;50;122;1
807;(403.5, 404.0);1059.3461538461538;0.0038966923076923093;69;61;130;1
808;(404.0, 404.5);991.8740740740741;0.003670511111111109;71;64;135;1
809;(404.5, 405.0);1019.8503937007874;0.0036978818897637784;65;62;127;1
810;(405.0, 405.5);1040.3;0.0034916071428571427;76;64;140;1
811;(405.5, 406.0);1029.7424242424242;0.0036520757575757563;70;62;132;1
812;(406.0, 406.5);1049.234375;0.0038797968750000013;66;62;128;1
813;(406.5, 407.0);1050.7094017094016;0.00413323076923077;61;56;117;1
814;(407.0, 407.5);1061.9366197183099;0.003532718309859153;78;64;142;1
815;(407.5, 408.0);983.6764705882352;0.0035190808823529407;75;61;136;1
816;(408.0, 408.5);973.7615384615384;0.0038055846153846142;68;62;130;1
817;(408.5, 409.0);986.5573770491803;0.004096081967213114;69;53;122;1
818;(409.0, 409.5);1035.121951219512;0.004029284552845527;65;58;123;1
819;(409.5, 410.0);1048.3548387096773;0.00396633064516129;64;60;124;1
820;(410.0, 410.5);1008.9527559055118;0.003893511811023621;63;64;127;1
821;(410.5, 411.0);963.6616541353384;0.0035366691729323317;77;56;133;1
822;(411.0, 411.5);922.8888888888889;0.004579148148148146;65;43;108;1
823;(411.5, 412.0);876.5230769230769;0.003737123076923077;71;59;130;1
824;(412.0, 412.5);965.3421052631579;0.004463789473684208;65;49;114;1
825;(412.5, 413.0);964.544;0.003749575999999999;67;58;125;1
826;(413.0, 413.5);944.7226890756302;0.00418796638655462;70;49;119;1
827;(413.5, 414.0);919.9083333333333;0.00406535833333333;68;52;120;1
828;(414.0, 414.5);969.655462184874;0.0041975966386554615;63;56;119;1
829;(414.5, 415.0);926.7652173913043;0.0042537478260869545;67;48;115;1
830;(415.0, 415.5);903.4710743801653;0.0036904380165289235;69;52;121;1
831;(415.5, 416.0);882.1981132075472;0.004749981132075471;70;36;106;1
832;(416.0, 416.5);980.8684210526316;0.004320526315789472;67;47;114;1
833;(416.5, 417.0);992.3730158730159;0.004040944444444445;66;60;126;1
834;(417.0, 417.5);997.16;0.0038118959999999986;70;55;125;1
835;(417.5, 418.0);928.8679245283018;0.004729433962264151;66;40;106;1
836;(418.0, 418.5);929.3893805309734;0.004225292035398227;70;43;113;1
837;(418.5, 419.0);993.3783783783783;0.004473324324324324;62;49;111;1
838;(419.0, 419.5);922.21875;0.0036821406249999983;72;56;128;1
839;(419.5, 420.0);975.9426229508197;0.00394989344262295;70;52;122;1
840;(420.0, 420.5);1028.532110091743;0.003949321100917431;60;49;109;1
841;(420.5, 421.0);1038.4661016949153;0.004219406779661015;53;65;118;0
842;(421.0, 421.5);1039.1304347826087;0.0035481304347826084;74;64;138;0
843;(421.5, 422.0);1035.3125;0.0034662013888888885;80;64;144;0
844;(422.0, 422.5);1053.9485294117646;0.003675544117647057;80;56;136;0
845;(422.5, 423.0);1002.8905109489051;0.0036477591240875904;68;69;137;0
846;(423.0, 423.5);1036.8992248062016;0.0037028837209302306;67;62;129;0
847;(423.5, 424.0);1049.8059701492537;0.003673119402985075;74;60;134;0
848;(424.0, 424.5);1041.7131782945737;0.0038629999999999975;66;63;129;0
849;(424.5, 425.0);1038.978417266187;0.0035906978417266184;74;65;139;0
850;(425.0, 425.5);1013.3015873015873;0.0037018333333333335;69;57;126;0
851;(425.5, 426.0);927.9044117647059;0.0036669411764705877;72;64;136;0
852;(426.0, 426.5);936.5;0.0047776326530612236;69;29;98;0
853;(426.5, 427.0);868.3786407766991;0.004748543689320387;75;28;103;0
854;(427.0, 427.5);940.0849056603773;0.004559311320754714;67;39;106;0
855;(427.5, 428.0);949.7204301075269;0.005174741935483872;73;20;93;0
856;(428.0, 428.5);945.62;0.004854859999999999;69;31;100;0
857;(428.5, 429.0);994.8720930232558;0.005829162790697674;67;19;86;0
858;(429.0, 429.5);987.9565217391304;0.005369608695652172;70;22;92;0
859;(429.5, 430.0);1020.5;0.005324042553191488;71;23;94;0
860;(430.0, 430.5);961.71875;0.004956885416666665;73;23;96;0
861;(430.5, 431.0);940.0792079207921;0.004940217821782176;78;23;101;0
862;(431.0, 431.5);999.1022727272727;0.005544931818181819;69;19;88;0
863;(431.5, 432.0);987.8111111111111;0.005478733333333331;70;20;90;0
864;(432.0, 432.5);989.0425531914893;0.00532677659574468;73;21;94;0
865;(432.5, 433.0);1018.3333333333334;0.005103895833333332;77;19;96;0
866;(433.0, 433.5);991.3736263736264;0.005113582417582415;69;22;91;0
867;(433.5, 434.0);1020.9230769230769;0.005150747252747254;74;17;91;0
868;(434.0, 434.5);913.4842105263158;0.004875915789473686;74;21;95;0
869;(434.5, 435.0);985.5747126436781;0.005625333333333333;70;17;87;0
870;(435.0, 435.5);961.2647058823529;0.00465442156862745;84;18;102;0
871;(435.5, 436.0);1086.482142857143;0.004297080357142855;74;38;112;0
872;(436.0, 436.5);978.0650406504066;0.004073113821138211;75;48;123;0
873;(436.5, 437.0);1032.0681818181818;0.005503465909090908;72;16;88;0
874;(437.0, 437.5);1026.8444444444444;0.005537355555555555;70;20;90;0
875;(437.5, 438.0);996.2173913043479;0.005393608695652173;74;18;92;0
876;(438.0, 438.5);961.3258426966293;0.005491786516853932;73;16;89;0
877;(438.5, 439.0);1030.1222222222223;0.005538822222222221;74;16;90;0
878;(439.0, 439.5);1013.0;0.005797714285714286;68;16;84;0
879;(439.5, 440.0);1012.3118279569892;0.0051883118279569896;79;14;93;0
880;(440.0, 440.5);970.1263157894737;0.005200873684210524;74;21;95;0
881;(440.5, 441.0);1021.0;0.0051634680851063855;75;19;94;0
882;(441.0, 441.5);1012.1612903225806;0.005275064516129031;75;18;93;0
883;(441.5, 442.0);908.0754716981132;0.004501132075471697;81;25;106;0
884;(442.0, 442.5);1042.6842105263158;0.004973231578947368;77;18;95;0
885;(442.5, 443.0);964.6464646464647;0.005079090909090909;78;21;99;0
886;(443.0, 443.5);987.5263157894736;0.0051489473684210516;79;16;95;0
887;(443.5, 444.0);1008.625;0.005221635416666666;76;20;96;0
888;(444.0, 444.5);1037.4242424242425;0.004998535353535354;82;17;99;0
889;(444.5, 445.0);987.75;0.005496684782608695;74;18;92;0
890;(445.0, 445.5);902.0275229357799;0.004317293577981649;81;28;109;0
891;(445.5, 446.0);966.89;0.004762480000000001;80;20;100;0
892;(446.0, 446.5);1001.0531914893617;0.005151925531914893;75;19;94;0
893;(446.5, 447.0);1007.6875;0.005037802083333333;77;19;96;0
894;(447.0, 447.5);970.3875;0.006124074999999998;62;18;80;0
895;(447.5, 448.0);972.4395604395604;0.005586384615384615;72;19;91;0
896;(448.0, 448.5);955.4880952380952;0.005796773809523807;65;19;84;0
897;(448.5, 449.0);951.3977272727273;0.005710477272727273;69;19;88;0
898;(449.0, 449.5);871.4516129032259;0.005204666666666665;71;22;93;0
899;(449.5, 450.0);989.7764705882353;0.005670364705882353;69;16;85;0
900;(450.0, 450.5);937.8181818181819;0.005410943181818181;70;18;88;0
901;(450.5, 451.0);964.3225806451613;0.00546779569892473;72;21;93;0
902;(451.0, 451.5);905.8522727272727;0.005608670454545452;70;18;88;0
903;(451.5, 452.0);955.0760869565217;0.005358423913043476;74;18;92;0
904;(452.0, 452.5);954.6235294117647;0.0059951647058823524;66;19;85;0
905;(452.5, 453.0);956.42;0.004844259999999998;74;26;100;0
906;(453.0, 453.5);922.4285714285714;0.005383835164835164;71;20;91;0
907;(453.5, 454.0);958.6914893617021;0.005426021276595746;72;22;94;0
908;(454.0, 454.5);999.3658536585366;0.005975499999999998;67;15;82;0
909;(454.5, 455.0);998.8735632183908;0.005697298850574714;71;16;87;0
910;(455.0, 455.5);1006.6888888888889;0.005331766666666665;73;17;90;0
911;(455.5, 456.0);1003.7362637362637;0.005467857142857142;71;20;91;0
912;(456.0, 456.5);1009.2857142857143;0.0058023690476190475;68;16;84;0
913;(456.5, 457.0);913.0769230769231;0.004865384615384615;78;26;104;0
914;(457.0, 457.5);1023.3837209302326;0.005504976744186047;68;18;86;0
915;(457.5, 458.0);1013.8720930232558;0.0055395581395348845;68;18;86;0
916;(458.0, 458.5);1036.685393258427;0.00546405617977528;73;16;89;0
917;(458.5, 459.0);1043.5842696629213;0.00566267415730337;72;17;89;0
918;(459.0, 459.5);1032.3516483516485;0.005500868131868132;74;17;91;0
919;(459.5, 460.0);1013.6785714285714;0.00593577380952381;64;20;84;0
920;(460.0, 460.5);990.6082474226804;0.004742917525773194;80;17;97;0
921;(460.5, 461.0);958.8247422680413;0.004994422680412371;74;23;97;0
922;(461.0, 461.5);1038.6421052631579;0.005265663157894738;76;19;95;0
923;(461.5, 462.0);1033.3958333333333;0.0052255729166666666;79;17;96;0
924;(462.0, 462.5);997.8735632183908;0.005739183908045975;67;20;87;0
925;(462.5, 463.0);1001.0918367346939;0.005104000000000001;80;18;98;0
926;(463.0, 463.5);1034.0;0.0052928064516129004;75;18;93;0
927;(463.5, 464.0);1037.125;0.00527678125;80;16;96;0
928;(464.0, 464.5);934.979797979798;0.004626575757575756;78;21;99;0
929;(464.5, 465.0);1064.86;0.00494619;84;16;100;0
930;(465.0, 465.5);1025.637254901961;0.004778735294117647;85;17;102;0
931;(465.5, 466.0);1018.69;0.005036629999999999;80;20;100;0
932;(466.0, 466.5);1023.9375;0.004906427083333332;78;18;96;0
933;(466.5, 467.0);1065.6929824561403;0.0044907456140350875;96;18;114;0
934;(467.0, 467.5);1077.4336283185842;0.004374442477876104;95;18;113;0
935;(467.5, 468.0);1002.1240310077519;0.003820457364341086;100;29;129;0
936;(468.0, 468.5);1015.5;0.0042225775862068955;98;18;116;0
937;(468.5, 469.0);1031.4112903225807;0.003958096774193547;103;21;124;0
938;(469.0, 469.5);1073.7478991596638;0.004171378151260504;101;18;119;0
939;(469.5, 470.0);1070.3274336283187;0.004373283185840709;95;18;113;0
940;(470.0, 470.5);1095.6950354609928;0.003580794326241135;121;20;141;0
941;(470.5, 471.0);1074.9242424242425;0.003687189393939395;113;19;132;0
942;(471.0, 471.5);1097.7230769230769;0.003784692307692307;112;18;130;0
943;(471.5, 472.0);1021.9006622516556;0.0032697350993377483;121;30;151;0
944;(472.0, 472.5);1090.7185185185185;0.0037184740740740735;118;17;135;0
945;(472.5, 473.0);1092.390977443609;0.0036183609022556406;113;20;133;0
946;(473.0, 473.5);1077.216;0.003965880000000001;107;18;125;0
947;(473.5, 474.0);1102.6953642384105;0.003157119205298014;131;20;151;0
948;(474.0, 474.5);1096.7482014388488;0.003600633093525181;118;21;139;0
949;(474.5, 475.0);1099.1;0.003617585714285714;122;18;140;0
950;(475.0, 475.5);1074.1492537313434;0.0035650746268656728;113;21;134;0
951;(475.5, 476.0);1050.979020979021;0.00329404895104895;121;22;143;0
952;(476.0, 476.5);1116.4701492537313;0.003797194029850744;117;17;134;0
953;(476.5, 477.0);1123.2348484848485;0.0037102272727272717;117;15;132;0
954;(477.0, 477.5);1087.823076923077;0.003797138461538461;106;24;130;0
955;(477.5, 478.0);1055.9204545454545;0.0028466193181818163;133;43;176;0
956;(478.0, 478.5);1069.6709677419356;0.003131606451612903;115;40;155;0
957;(478.5, 479.0);1086.6099290780141;0.0034960425531914883;115;26;141;0
958;(479.0, 479.5);1032.1666666666667;0.0030619400000000013;127;23;150;0
959;(479.5, 480.0);1066.4615384615386;0.003927300000000001;113;17;130;0
960;(480.0, 480.5);1102.237037037037;0.0036403037037037026;120;15;135;0
961;(480.5, 481.0);1097.25;0.0035521928571428567;119;21;140;0
962;(481.0, 481.5);1090.7692307692307;0.0034774125874125865;121;22;143;0
963;(481.5, 482.0);1113.7537313432836;0.0036944328358208974;117;17;134;1
964;(482.0, 482.5);1136.012658227848;0.0030979683544303796;118;40;158;1
965;(482.5, 483.0);1108.611111111111;0.004022095238095237;62;64;126;1
966;(483.0, 483.5);1110.7961165048544;0.002378679611650485;144;62;206;1
967;(483.5, 484.0);1179.8954248366013;0.0032464248366013086;99;54;153;1
968;(484.0, 484.5);1131.8815789473683;0.003054302631578946;89;63;152;1
969;(484.5, 485.0);1169.6209150326797;0.0032623856209150312;96;57;153;1
970;(485.0, 485.5);1170.951871657754;0.0026400320855614963;139;48;187;1
971;(485.5, 486.0);1167.8940397350993;0.003141768211920529;105;46;151;1
972;(486.0, 486.5);1158.8193548387096;0.003132541935483871;107;48;155;1
973;(486.5, 487.0);1137.4189944134077;0.002783759776536312;129;50;179;1
974;(487.0, 487.5);1191.456375838926;0.003322288590604028;103;46;149;1
975;(487.5, 488.0);1157.922619047619;0.0028526011904761884;117;51;168;1
976;(488.0, 488.5);1183.1272727272728;0.0029156545454545437;114;51;165;1
977;(488.5, 489.0);1185.7902097902097;0.0035023426573426576;95;48;143;1
978;(489.0, 489.5);1164.5384615384614;0.0031626602564102557;105;51;156;1
979;(489.5, 490.0);1170.953642384106;0.0032455496688741695;102;49;151;1
980;(490.0, 490.5);1124.8590604026845;0.0031264228187919455;93;56;149;1
981;(490.5, 491.0);1082.590909090909;0.0031909090909090893;98;56;154;1
982;(491.0, 491.5);1157.006711409396;0.003356053691275167;99;50;149;1
983;(491.5, 492.0);1142.796052631579;0.003185802631578946;103;49;152;1
984;(492.0, 492.5);1167.5065789473683;0.0032875460526315767;103;49;152;1
985;(492.5, 493.0);1165.159420289855;0.0036409565217391288;88;50;138;1
986;(493.0, 493.5);1128.1059602649007;0.003235278145695363;98;53;151;1
987;(493.5, 494.0);1119.1688311688313;0.003250019480519481;99;55;154;1
988;(494.0, 494.5);1030.63309352518;0.003452172661870501;76;63;139;1
989;(494.5, 495.0);1089.8881118881118;0.003463902097902096;86;57;143;1
990;(495.0, 495.5);1101.1151079136691;0.0035162949640287766;84;55;139;1
991;(495.5, 496.0);1110.0222222222221;0.0036033925925925935;83;52;135;1
992;(496.0, 496.5);1089.1224489795918;0.005058877551020407;47;51;98;1
993;(496.5, 497.0);1111.9617834394905;0.002896745222929937;105;52;157;1
994;(497.0, 497.5);1087.6402877697842;0.003653539568345321;82;57;139;1
995;(497.5, 498.0);1040.2301587301588;0.003575000000000001;68;58;126;1
996;(498.0, 498.5);1018.2;0.003474855172413793;84;61;145;1
997;(498.5, 499.0);1005.560975609756;0.004001861788617885;80;43;123;1
998;(499.0, 499.5);1064.8983050847457;0.0042476016949152505;72;46;118;1
999;(499.5, 500.0);1119.7027027027027;0.004388252252252251;74;37;111;1
1000;(500.0, 500.5);1147.6306306306305;0.004388666666666666;73;38;111;1
1001;(500.5, 501.0);1138.482456140351;0.004245929824561404;79;35;114;1
1002;(501.0, 501.5);1126.7962962962963;0.004559453703703703;69;39;108;1
1003;(501.5, 502.0);1099.0877192982457;0.00427540350877193;75;39;114;1
1004;(502.0, 502.5);1121.485436893204;0.0046750679611650475;68;35;103;1
1005;(502.5, 503.0);1163.017094017094;0.004252034188034188;77;40;117;1
1006;(503.0, 503.5);1098.0105263157895;0.004902842105263158;63;32;95;1
1007;(503.5, 504.0);1090.7444444444445;0.005286500000000002;56;34;90;1
1008;(504.0, 504.5);1032.2235294117647;0.005778870588235296;55;30;85;1
1009;(504.5, 505.0);966.3958333333334;0.005373781250000002;57;39;96;1
1010;(505.0, 505.5);970.1203703703703;0.0045825648148148145;66;42;108;1
1011;(505.5, 506.0);953.3181818181819;0.004436727272727274;61;49;110;1
1012;(506.0, 506.5);1005.4907407407408;0.004619111111111109;68;40;108;1
1013;(506.5, 507.0);993.2169811320755;0.004407792452830191;61;45;106;1
1014;(507.0, 507.5);1001.25;0.004348336206896549;53;63;116;1
1015;(507.5, 508.0);993.9203539823009;0.004233194690265485;48;65;113;1
1016;(508.0, 508.5);976.9236641221374;0.0037868854961832063;65;66;131;1
1017;(508.5, 509.0);959.2936507936508;0.003885031746031743;58;68;126;1
1018;(509.0, 509.5);927.5365853658536;0.0038989593495934965;50;73;123;1
1019;(509.5, 510.0);965.3675213675214;0.004222923076923075;57;60;117;1
1020;(510.0, 510.5);961.0808080808081;0.004697666666666666;54;45;99;1
1021;(510.5, 511.0);949.1176470588235;0.004733470588235293;58;44;102;1
1022;(511.0, 511.5);947.375;0.0037364249999999994;81;39;120;1
1023;(511.5, 512.0);881.3875968992248;0.003942201550387598;85;44;129;1
1024;(512.0, 512.5);921.8018867924528;0.004478716981132075;65;41;106;1
1025;(512.5, 513.0);848.4360902255639;0.0037084511278195472;81;52;133;1
1026;(513.0, 513.5);863.6484375;0.0036631406249999997;81;47;128;1
1027;(513.5, 514.0);878.1121495327103;0.004603084112149535;68;39;107;1
1028;(514.0, 514.5);937.2416666666667;0.004069383333333332;81;39;120;1
1029;(514.5, 515.0);945.5565217391304;0.0043099913043478265;70;45;115;1
1030;(515.0, 515.5);872.516393442623;0.003991983606557376;77;45;122;1
1031;(515.5, 516.0);848.6796875;0.003731484374999999;80;48;128;1
1032;(516.0, 516.5);846.9291338582677;0.003821503937007873;85;42;127;1
1033;(516.5, 517.0);785.8220338983051;0.00405656779661017;71;47;118;1
1034;(517.0, 517.5);875.6229508196722;0.003951155737704918;72;50;122;1
1035;(517.5, 518.0);867.5210084033613;0.004122756302521006;67;52;119;1
1036;(518.0, 518.5);851.1138211382114;0.003949780487804878;74;49;123;1
1037;(518.5, 519.0);852.9112903225806;0.003983903225806451;70;54;124;1
1038;(519.0, 519.5);882.2622950819672;0.003967426229508198;70;52;122;1
1039;(519.5, 520.0);888.8672566371681;0.00447614159292035;60;53;113;1
1040;(520.0, 520.5);841.472;0.0038312319999999995;65;60;125;1
1041;(520.5, 521.0);880.5895522388059;0.003756723880597014;76;58;134;1
1042;(521.0, 521.5);977.1940298507462;0.0036985895522388037;75;59;134;1
1043;(521.5, 522.0);991.4166666666666;0.004150666666666666;75;45;120;1
1044;(522.0, 522.5);1030.909090909091;0.0038070661157024776;65;56;121;1
1045;(522.5, 523.0);995.2301587301587;0.003921499999999998;70;56;126;1
1046;(523.0, 523.5);989.3414634146342;0.004051577235772356;64;59;123;1
1047;(523.5, 524.0);1024.3688524590164;0.004105680327868852;69;53;122;1
1048;(524.0, 524.5);960.875;0.0033711691176470577;77;59;136;1
1049;(524.5, 525.0);1003.5307692307692;0.0038780538461538456;73;57;130;1
1050;(525.0, 525.5);1026.6153846153845;0.0037616769230769237;78;52;130;1
1051;(525.5, 526.0);953.2926829268292;0.003990333333333332;75;48;123;1
1052;(526.0, 526.5);1048.486956521739;0.004188052173913043;67;48;115;1
1053;(526.5, 527.0);997.608;0.004037296;69;56;125;1
1054;(527.0, 527.5);1032.7080291970804;0.0035897518248175163;82;55;137;1
1055;(527.5, 528.0);987.952380952381;0.0038376269841269837;69;57;126;1
1056;(528.0, 528.5);1000.463768115942;0.003608362318840579;77;61;138;1
1057;(528.5, 529.0);1057.824;0.004006072000000001;72;53;125;1
1058;(529.0, 529.5);1034.7333333333333;0.0036939629629629623;79;56;135;1
1059;(529.5, 530.0);992.6746031746031;0.0038822222222222244;69;57;126;1
1060;(530.0, 530.5);1014.0583333333333;0.0042401666666666655;65;55;120;1
1061;(530.5, 531.0);981.3613445378152;0.004068487394957982;59;60;119;1
1062;(531.0, 531.5);1032.1076923076923;0.003840446153846153;73;57;130;1
1063;(531.5, 532.0);947.4621212121212;0.0035373409090909075;71;61;132;1
1064;(532.0, 532.5);994.7816901408451;0.0035900633802816904;90;52;142;1
1065;(532.5, 533.0);1038.0409836065573;0.003927745901639343;75;47;122;1
1066;(533.0, 533.5);966.3875968992248;0.0039120852713178285;76;53;129;1
1067;(533.5, 534.0);975.1367521367522;0.004127094017094015;63;54;117;1
1068;(534.0, 534.5);1009.6220472440945;0.003983952755905511;77;50;127;1
1069;(534.5, 535.0);997.1153846153846;0.003738730769230771;76;54;130;1
1070;(535.0, 535.5);941.5430463576159;0.0029818013245033127;93;58;151;1
1071;(535.5, 536.0);930.6382978723404;0.003368156028368795;81;60;141;1
1072;(536.0, 536.5);977.0225563909775;0.0038222857142857156;75;58;133;1
1073;(536.5, 537.0);999.5785123966942;0.004100314049586776;67;54;121;1
1074;(537.0, 537.5);1018.3253968253969;0.003920126984126984;71;55;126;1
1075;(537.5, 538.0);1024.5692307692307;0.003791823076923077;72;58;130;1
1076;(538.0, 538.5);1044.782258064516;0.003973338709677417;71;53;124;1
1077;(538.5, 539.0);1026.7404580152672;0.0038020763358778613;74;57;131;1
1078;(539.0, 539.5);958.4676258992806;0.003534064748201438;77;62;139;1
1079;(539.5, 540.0);1004.2204724409448;0.003812519685039369;70;57;127;1
1080;(540.0, 540.5);997.2595419847328;0.003822564885496183;74;57;131;1
1081;(540.5, 541.0);1029.6567164179105;0.0033375373134328363;79;55;134;0
1082;(541.0, 541.5);1022.6829268292682;0.004026308943089432;64;59;123;0
1083;(541.5, 542.0);1022.6507936507936;0.003763380952380951;72;54;126;0
1084;(542.0, 542.5);1035.6041666666667;0.0034708124999999986;86;58;144;0
1085;(542.5, 543.0);998.2248062015503;0.0037347286821705406;72;57;129;0
1086;(543.0, 543.5);974.3138686131387;0.0036984671532846714;77;60;137;0
1087;(543.5, 544.0);1040.0852713178294;0.0037705891472868216;74;55;129;0
1088;(544.0, 544.5);1011.198347107438;0.0040586859504132215;63;58;121;0
1089;(544.5, 545.0);1029.3111111111111;0.003616325925925926;80;55;135;0
1090;(545.0, 545.5);974.2781954887218;0.0037617518796992473;73;60;133;0
1091;(545.5, 546.0);965.4107142857143;0.004071499999999998;79;33;112;0
1092;(546.0, 546.5);991.0816326530612;0.004905551020408166;73;25;98;0
1093;(546.5, 547.0);981.6062992125984;0.003820496062992126;73;54;127;0
1094;(547.0, 547.5);1015.0709219858156;0.003542063829787234;84;57;141;0
1095;(547.5, 548.0);968.4961240310078;0.0037560232558139527;67;62;129;0
1096;(548.0, 548.5);979.4434782608696;0.00403855652173913;83;32;115;0
1097;(548.5, 549.0);1013.4947368421052;0.005068263157894737;75;20;95;0
1098;(549.0, 549.5);1005.3469387755102;0.0050472755102040825;76;22;98;0
1099;(549.5, 550.0);1038.5760869565217;0.0053192499999999985;75;17;92;0
1100;(550.0, 550.5);958.4;0.004515181818181819;81;29;110;0
1101;(550.5, 551.0);952.152380952381;0.0046394190476190455;80;25;105;0
1102;(551.0, 551.5);979.5148514851485;0.005041356435643561;77;24;101;0
1103;(551.5, 552.0);990.8105263157895;0.005191305263157894;75;20;95;0
1104;(552.0, 552.5);990.3333333333334;0.004244763157894737;79;35;114;0
1105;(552.5, 553.0);991.3703703703703;0.004616722222222222;79;29;108;0
1106;(553.0, 553.5);958.8217821782179;0.004709732673267324;74;27;101;0
1107;(553.5, 554.0);1002.3063063063063;0.004588648648648648;83;28;111;0
1108;(554.0, 554.5);912.2857142857143;0.004249267857142857;77;35;112;0
1109;(554.5, 555.0);988.3589743589744;0.0064976666666666655;57;21;78;0
1110;(555.0, 555.5);1053.8620689655172;0.004143577586206895;98;18;116;0
1111;(555.5, 556.0);1010.33;0.004617129999999998;81;19;100;0
1112;(556.0, 556.5);977.3775510204082;0.004958275510204079;74;24;98;0
1113;(556.5, 557.0);1009.2736842105263;0.00521022105263158;77;18;95;0
1114;(557.0, 557.5);1033.939393939394;0.004826939393939393;80;19;99;0
1115;(557.5, 558.0);953.5137614678899;0.004456155963302751;73;36;109;0
1116;(558.0, 558.5);910.569105691057;0.0036845203252032525;81;42;123;0
1117;(558.5, 559.0);977.4789915966387;0.004291806722689075;77;42;119;0
1118;(559.0, 559.5);1000.3106796116505;0.004679912621359222;78;25;103;0
1119;(559.5, 560.0);1022.2043010752689;0.00544194623655914;73;20;93;0
1120;(560.0, 560.5);996.0526315789474;0.005200421052631577;75;20;95;0
1121;(560.5, 561.0);983.5656565656566;0.0043471414141414135;77;22;99;0
1122;(561.0, 561.5);993.3203883495146;0.004861058252427185;83;20;103;0
1123;(561.5, 562.0);892.5625;0.004468616071428571;74;38;112;0
1124;(562.0, 562.5);1011.73;0.005008619999999997;78;22;100;0
1125;(562.5, 563.0);1046.2659574468084;0.004977553191489359;76;18;94;0
1126;(563.0, 563.5);1073.962962962963;0.0045717777777777744;64;44;108;0
1127;(563.5, 564.0);1016.265625;0.003788992187499999;79;49;128;0
1128;(564.0, 564.5);993.6491228070175;0.004462692982456137;74;40;114;0
1129;(564.5, 565.0);993.8260869565217;0.0042516173913043475;76;39;115;0
1130;(565.0, 565.5);923.1206896551724;0.00811001724137931;35;23;58;0
1131;(565.5, 566.0);958.8194444444445;0.0035206388888888887;112;32;144;0
1132;(566.0, 566.5);1029.25;0.004628472222222223;78;30;108;0
1133;(566.5, 567.0);1003.5049504950495;0.004937653465346532;70;31;101;0
1134;(567.0, 567.5);1039.5922330097087;0.004842951456310679;80;23;103;0
1135;(567.5, 568.0);1017.2527472527472;0.005116901098901097;70;21;91;0
1136;(568.0, 568.5);991.0776699029126;0.00476731067961165;78;25;103;0
1137;(568.5, 569.0);1030.3333333333333;0.005019197916666665;72;24;96;0
1138;(569.0, 569.5);904.6635514018692;0.004496719626168223;79;28;107;0
1139;(569.5, 570.0);987.16;0.0062752;57;18;75;0
1140;(570.0, 570.5);1047.509090909091;0.00444650909090909;91;19;110;0
1141;(570.5, 571.0);995.9555555555555;0.005356477777777779;71;19;90;0
1142;(571.0, 571.5);1004.6701030927835;0.004839422680412372;77;20;97;0
1143;(571.5, 572.0);1035.2857142857142;0.0054636593406593385;72;19;91;0
1144;(572.0, 572.5);950.3838383838383;0.004807373737373736;78;21;99;0
1145;(572.5, 573.0);1005.2978723404256;0.0051869468085106365;73;21;94;0
1146;(573.0, 573.5);921.4343434343434;0.004676020202020202;78;21;99;0
1147;(573.5, 574.0);1010.3673469387755;0.004973479591836735;75;23;98;0
1148;(574.0, 574.5);1026.3020833333333;0.005167000000000001;74;22;96;0
1149;(574.5, 575.0);1009.2826086956521;0.005450119565217392;71;21;92;0
1150;(575.0, 575.5);991.6565656565657;0.005042545454545454;76;23;99;0
1151;(575.5, 576.0);1015.0102040816327;0.004914602040816327;79;19;98;0
1152;(576.0, 576.5);982.5353535353536;0.004812838383838385;76;23;99;0
1153;(576.5, 577.0);954.6822429906542;0.004343271028037383;83;24;107;0
1154;(577.0, 577.5);1028.2935779816514;0.004512899082568808;88;21;109;0
1155;(577.5, 578.0);1020.7403846153846;0.004828875000000001;82;22;104;0
1156;(578.0, 578.5);1005.2929292929293;0.0046462828282828285;80;19;99;0
1157;(578.5, 579.0);1035.2924528301887;0.004813632075471698;85;21;106;0
1158;(579.0, 579.5);1011.5;0.004416584905660377;84;22;106;0
1159;(579.5, 580.0);956.7663551401869;0.004416280373831775;82;25;107;0
1160;(580.0, 580.5);993.0366972477065;0.004231440366972475;87;22;109;0
1161;(580.5, 581.0);942.5309734513274;0.004372876106194688;88;25;113;0
1162;(581.0, 581.5);1026.96;0.00477792;82;18;100;0
1163;(581.5, 582.0);1013.1456310679612;0.004840912621359221;82;21;103;0
1164;(582.0, 582.5);1031.7596153846155;0.004547999999999998;83;21;104;0
1165;(582.5, 583.0);1019.340206185567;0.005011721649484535;77;20;97;0
1166;(583.0, 583.5);1021.8190476190476;0.004576419047619048;88;17;105;0
1167;(583.5, 584.0);1023.10101010101;0.004922323232323232;80;19;99;0
1168;(584.0, 584.5);923.2857142857143;0.004276375000000001;86;26;112;0
1169;(584.5, 585.0);980.2818181818182;0.004621027272727272;88;22;110;0
1170;(585.0, 585.5);1019.7476635514018;0.0044918130841121486;84;23;107;0
1171;(585.5, 586.0);996.7547169811321;0.004465283018867925;83;23;106;0
1172;(586.0, 586.5);1012.9345794392524;0.004007728971962616;85;22;107;0
1173;(586.5, 587.0);993.3469387755102;0.0051230918367346934;76;22;98;0
1174;(587.0, 587.5);1005.3762376237623;0.004919217821782179;83;18;101;0
1175;(587.5, 588.0);1004.1495327102804;0.004512850467289718;86;21;107;0
1176;(588.0, 588.5);939.3333333333334;0.004422639639639639;88;23;111;0
1177;(588.5, 589.0);1030.8653846153845;0.004781932692307693;83;21;104;0
1178;(589.0, 589.5);1013.5742574257425;0.004840178217821782;82;19;101;0
1179;(589.5, 590.0);1005.8653846153846;0.004876865384615385;83;21;104;0
1180;(590.0, 590.5);1005.242718446602;0.004777300970873787;82;21;103;0
1181;(590.5, 591.0);985.2685185185185;0.0045094814814814815;85;23;108;0
1182;(591.0, 591.5);1012.9902912621359;0.00447168932038835;84;19;103;0
1183;(591.5, 592.0);929.5779816513761;0.004327311926605503;84;25;109;0
1184;(592.0, 592.5);1028.047619047619;0.004782466666666665;84;21;105;0
1185;(592.5, 593.0);1029.5922330097087;0.004855262135922329;86;17;103;0
1186;(593.0, 593.5);986.059405940594;0.004915831683168315;81;20;101;0
1187;(593.5, 594.0);1004.2330097087379;0.0048512427184465995;83;20;103;0
1188;(594.0, 594.5);999.5377358490566;0.004668622641509432;86;20;106;0
1189;(594.5, 595.0);995.009900990099;0.0049250099009900995;80;21;101;0
1190;(595.0, 595.5);968.0480769230769;0.004522711538461537;80;24;104;0
1191;(595.5, 596.0);944.5849056603773;0.004768283018867924;83;23;106;0
1192;(596.0, 596.5);975.4888888888889;0.005424133333333332;68;22;90;0
1193;(596.5, 597.0);991.6421052631579;0.005169231578947367;74;21;95;0
1194;(597.0, 597.5);1020.9090909090909;0.0050083737373737384;81;18;99;0
1195;(597.5, 598.0);1004.2150537634409;0.005094774193548386;73;20;93;0
1196;(598.0, 598.5);991.09375;0.005228041666666668;73;23;96;0
1197;(598.5, 599.0);1064.063829787234;0.005280234042553188;76;18;94;0
1198;(599.0, 599.5);910.8137254901961;0.004409176470588235;77;25;102;0
1199;(599.5, 600.0);1011.9010989010989;0.0054848681318681305;71;20;91;0
1200;(600.0, 600.5);1031.7395833333333;0.004864927083333336;78;18;96;0
1201;(600.5, 601.0);974.7340425531914;0.005336148936170211;73;21;94;0
1202;(601.0, 601.5);993.3434343434343;0.004405909090909089;80;19;99;0
1203;(601.5, 602.0);995.2164948453608;0.004635030927835051;74;23;97;0
1204;(602.0, 602.5);1012.0322580645161;0.005251301075268817;72;21;93;0